//MAP CONVERTED BY dmm2tgm.py THIS HEADER COMMENT PREVENTS RECONVERSION, DO NOT REMOVE
"d" = (
/obj/structure/stairs,
/turf/open/floor/grass,
/area/hallway/primary/central)
"h" = (
/turf/closed/indestructible/rock/ms13/mammoth,
/area/hallway/primary/central)
"k" = (
/obj/structure/stairs,
/turf/open/floor/iron/stairs,
/area/hallway/primary/central)
"l" = (
/turf/open/floor/plating/ms13/ground/snow,
/area/hallway/primary/central)
"m" = (
/obj/effect/landmark/start/assistant,
/turf/open/floor/plating/ms13/ground/desert,
/area/hallway/primary/central)
"p" = (
/obj/effect/spawner/structure/window,
/turf/open/floor/iron/ms13/concrete,
/area/hallway/primary/central)
"s" = (
/obj/effect/landmark/observer_start,
/turf/open/floor/plating/ms13/ground/desert,
/area/hallway/primary/central)
"t" = (
/turf/open/floor/iron/ms13/ceramic,
/area/hallway/primary/central)
"u" = (
/turf/open/floor/plating/ms13/ground/desert,
/area/hallway/primary/central)
"v" = (
/turf/open/floor/iron/ms13/brick,
/area/hallway/primary/central)
"A" = (
/turf/open/openspace,
/area/hallway/primary/central)
"B" = (
/turf/open/floor/plating/ms13,
/area/hallway/primary/central)
"F" = (
/obj/machinery/light/cold/directional/north,
/turf/open/floor/iron/ms13/concrete/industrial/alt,
/area/hallway/primary/central)
"H" = (
/turf/closed/wall/r_wall/ms13/bunker,
/area/hallway/primary/central)
"I" = (
/turf/open/floor/iron/ms13/ceramic/ornate,
/area/hallway/primary/central)
"K" = (
/turf/open/floor/bronze,
/area/hallway/primary/central)
"L" = (
/turf/open/floor/iron/ms13/metal,
/area/hallway/primary/central)
"M" = (
/turf/open/floor/iron/ms13/concrete,
/area/hallway/primary/central)
"N" = (
/turf/closed/indestructible/rock/ms13,
/area/hallway/primary/central)
"O" = (
/turf/closed/wall,
/area/hallway/primary/central)
"P" = (
/turf/closed/indestructible/rock/ms13/drought,
/area/hallway/primary/central)
"R" = (
/turf/closed/indestructible/ms13/comb,
/area/hallway/primary/central)
"S" = (
/turf/open/floor/iron/stairs,
/area/hallway/primary/central)
"Z" = (
/turf/open/floor/iron/ms13/concrete/industrial/alt,
/area/hallway/primary/central)

(1,1,1) = {"
u
u
u
u
u
u
u
u
u
u
u
u
u
u
u
u
u
u
u
u
u
u
u
u
u
u
u
u
u
u
u
u
u
u
u
u
u
u
u
u
u
u
u
u
u
u
u
u
u
u
"}
(2,1,1) = {"
u
u
u
u
u
u
u
u
u
u
u
u
u
u
u
u
u
u
u
u
u
u
u
u
u
u
u
u
u
u
u
u
u
u
u
u
u
u
u
u
u
u
u
u
u
u
u
u
u
u
"}
(3,1,1) = {"
u
u
u
u
u
u
u
u
u
u
u
u
u
u
u
u
u
u
u
u
u
u
u
u
u
u
u
u
u
u
u
u
u
u
u
u
u
u
u
u
u
u
u
u
u
u
u
u
u
u
"}
(4,1,1) = {"
u
u
u
u
u
u
u
u
u
u
u
u
u
u
u
u
u
u
u
u
u
u
u
u
u
u
u
u
u
u
u
u
u
u
u
u
u
u
u
u
u
u
u
u
u
u
u
u
u
u
"}
(5,1,1) = {"
u
u
u
u
u
u
u
u
u
u
u
u
u
u
u
u
u
u
u
u
u
u
u
u
u
u
u
u
u
u
u
u
u
u
u
u
u
u
u
u
u
u
u
u
u
u
u
u
u
u
"}
(6,1,1) = {"
u
u
u
u
u
u
u
u
u
u
u
u
u
u
u
u
u
u
u
u
u
u
u
u
u
u
u
u
u
u
u
u
u
u
u
u
u
u
u
u
u
u
u
u
u
u
u
u
u
u
"}
(7,1,1) = {"
u
u
u
u
u
u
u
u
u
u
u
u
u
u
u
u
u
u
u
u
u
u
u
u
u
u
u
u
u
u
u
u
u
u
u
u
u
u
u
u
u
u
u
u
u
u
u
u
u
u
"}
(8,1,1) = {"
u
u
u
u
u
u
u
u
u
u
u
u
u
u
u
u
u
u
u
u
u
u
u
u
u
u
u
u
u
u
u
u
u
u
u
u
u
u
u
u
u
u
u
u
u
u
u
u
u
u
"}
(9,1,1) = {"
u
u
u
u
u
u
u
u
u
u
u
u
u
u
u
u
u
u
u
u
u
u
u
u
u
u
u
u
u
u
u
u
u
u
u
u
u
u
u
u
u
u
u
u
u
u
u
u
u
u
"}
(10,1,1) = {"
u
u
u
u
u
u
u
u
u
u
u
u
u
u
u
u
u
u
u
u
u
u
u
u
u
u
u
u
u
u
u
u
u
u
u
u
u
u
u
u
u
u
u
u
u
u
u
u
u
u
"}
(11,1,1) = {"
u
u
u
u
u
u
u
u
u
u
u
u
u
u
u
u
u
u
u
u
u
u
u
u
u
u
u
u
u
u
u
u
u
u
u
u
u
u
u
u
u
u
u
u
u
u
u
u
u
u
"}
(12,1,1) = {"
u
u
u
u
u
u
u
u
u
u
u
u
u
u
u
u
u
u
u
u
d
d
u
u
u
u
u
u
u
u
u
u
u
u
u
u
u
u
u
u
u
u
u
u
u
u
u
u
u
u
"}
(13,1,1) = {"
u
u
u
u
u
u
u
u
u
u
u
u
u
u
u
u
u
u
u
u
u
u
u
u
u
u
u
u
u
u
u
u
u
u
u
u
u
u
u
u
u
u
u
u
u
u
u
u
u
u
"}
(14,1,1) = {"
u
u
u
u
u
u
u
u
u
u
u
u
u
u
u
u
u
u
u
u
u
u
u
u
u
u
u
u
u
u
u
u
u
u
u
u
u
u
u
u
u
u
u
u
u
u
u
u
u
u
"}
(15,1,1) = {"
u
u
u
u
u
u
u
u
u
u
u
u
u
u
u
u
u
u
u
u
u
u
u
u
u
u
u
u
u
u
u
u
u
u
u
u
u
u
u
u
u
u
u
u
u
u
u
u
u
u
"}
(16,1,1) = {"
u
u
u
u
u
u
u
u
u
u
u
u
u
u
u
u
u
u
u
u
u
u
u
u
u
u
u
u
u
u
u
u
u
u
u
u
u
u
u
u
u
u
u
u
u
u
u
u
u
u
"}
(17,1,1) = {"
u
u
u
u
u
u
u
u
u
u
u
u
u
u
u
u
u
u
u
u
u
u
u
u
u
u
u
u
u
u
u
u
u
u
u
u
u
u
u
u
u
u
u
u
u
u
u
u
u
u
"}
(18,1,1) = {"
u
u
u
u
u
u
u
u
u
u
u
u
u
u
u
u
u
u
u
u
u
u
u
u
u
u
u
u
u
u
u
u
u
u
u
u
u
u
u
u
u
u
u
u
u
u
u
u
u
u
"}
(19,1,1) = {"
u
u
u
u
u
u
u
u
u
u
u
u
u
u
u
u
u
u
u
u
u
u
u
u
u
u
u
u
u
u
u
u
u
u
u
u
u
u
u
u
u
u
u
u
u
u
u
u
u
u
"}
(20,1,1) = {"
u
u
u
u
u
u
u
u
u
u
u
u
u
u
u
u
u
u
u
u
u
u
u
u
u
u
u
u
u
u
u
u
u
u
u
u
u
u
u
u
u
u
u
u
u
u
u
u
u
u
"}
(21,1,1) = {"
u
u
u
u
u
u
u
u
u
u
u
u
u
u
u
u
u
u
u
u
u
u
u
u
u
u
u
u
u
u
u
u
u
u
u
u
u
u
u
u
u
u
u
u
u
u
u
u
u
u
"}
(22,1,1) = {"
u
u
u
u
u
u
u
u
u
u
u
u
u
u
u
u
u
u
u
u
u
u
u
u
u
u
u
u
u
u
u
u
u
u
u
u
u
u
u
u
u
u
u
u
u
u
u
u
u
u
"}
(23,1,1) = {"
u
u
u
u
u
u
u
u
u
u
u
u
u
u
u
u
u
u
u
u
u
u
u
u
u
u
u
u
u
u
u
u
u
u
u
u
u
u
u
u
u
u
u
u
u
u
u
u
u
u
"}
(24,1,1) = {"
u
u
u
u
u
u
u
u
u
u
u
u
u
u
u
u
u
u
u
u
u
u
u
u
u
u
u
u
u
u
u
u
u
u
u
u
u
u
u
u
u
u
u
u
u
u
u
u
u
u
"}
(25,1,1) = {"
u
u
u
u
u
u
u
u
u
u
u
u
u
u
u
u
u
u
u
u
u
u
u
u
u
u
u
u
u
u
u
u
u
u
u
u
u
u
u
u
u
u
u
u
u
u
u
u
u
u
"}
(26,1,1) = {"
u
u
u
u
u
u
u
u
u
u
u
u
u
u
u
u
u
u
u
u
u
u
u
u
u
u
u
u
u
u
u
u
u
u
u
u
u
u
u
u
u
u
u
u
u
u
u
u
u
u
"}
(27,1,1) = {"
u
u
u
u
u
u
u
u
u
u
u
u
u
u
u
u
u
u
u
u
u
u
u
u
u
u
u
u
u
u
u
u
u
u
u
u
u
u
u
u
u
u
u
u
u
u
u
u
u
u
"}
(28,1,1) = {"
u
u
u
u
u
u
u
u
u
u
u
u
u
u
u
u
u
u
u
u
u
u
u
u
u
u
u
u
u
u
u
u
u
u
u
u
u
u
u
u
u
u
u
u
u
u
u
u
u
u
"}
(29,1,1) = {"
u
u
u
u
u
u
u
u
u
u
u
u
u
u
u
u
u
u
u
u
u
u
u
u
u
u
u
u
u
u
u
u
u
u
u
u
u
u
u
u
u
u
u
u
u
u
u
u
u
u
"}
(30,1,1) = {"
u
u
u
u
u
u
u
u
u
u
u
u
u
u
u
u
u
u
u
u
u
u
u
u
u
u
u
u
u
u
u
u
u
u
u
u
u
u
u
u
u
u
u
u
u
u
u
u
u
u
"}
(31,1,1) = {"
u
u
u
u
u
u
u
u
u
u
u
u
u
u
u
u
u
u
u
u
u
u
u
u
u
u
u
u
u
u
u
u
u
u
u
u
u
u
u
u
u
u
u
u
u
u
u
u
u
u
"}
(32,1,1) = {"
u
u
u
u
u
u
u
u
u
u
u
u
u
u
u
u
u
u
u
u
u
u
u
u
u
u
u
u
u
u
u
u
u
u
u
u
u
u
u
u
u
u
u
u
u
u
u
u
u
u
"}
(33,1,1) = {"
u
u
u
u
u
u
u
u
u
u
u
u
u
u
u
u
u
u
u
u
u
u
u
u
u
u
u
u
u
u
u
u
u
u
u
u
u
u
u
u
u
u
u
u
u
u
u
u
u
u
"}
(34,1,1) = {"
u
u
u
u
u
u
u
u
u
u
u
u
u
u
u
u
u
u
u
u
u
u
u
u
u
u
u
u
u
u
u
u
u
u
u
u
u
u
u
u
u
u
u
u
u
u
u
u
u
u
"}
(35,1,1) = {"
u
u
u
u
u
u
u
u
u
u
u
u
u
u
u
u
u
u
u
u
u
u
u
u
u
u
u
u
u
u
u
u
u
u
u
u
u
u
u
u
u
u
u
u
u
u
u
u
u
u
"}
(36,1,1) = {"
u
u
u
u
u
u
u
u
u
u
u
u
u
u
u
u
u
u
u
u
u
u
u
u
u
u
u
u
u
u
u
u
u
u
u
u
u
u
u
u
u
u
u
u
u
u
u
u
u
u
"}
(37,1,1) = {"
u
u
u
u
u
u
u
u
u
u
u
u
u
u
u
u
u
u
u
u
u
u
u
u
u
u
u
u
u
u
u
u
u
u
u
u
u
u
u
u
u
u
u
u
u
u
u
u
u
u
"}
(38,1,1) = {"
u
u
u
u
u
u
u
u
u
u
u
u
u
u
u
u
u
u
u
u
u
u
u
u
u
u
u
u
u
u
u
u
u
u
u
u
u
u
u
u
u
u
u
u
u
u
u
u
u
u
"}
(39,1,1) = {"
u
u
u
u
u
u
u
u
u
u
u
u
u
u
u
u
u
u
u
u
u
u
u
u
u
u
u
u
u
u
u
u
u
u
u
u
u
u
u
u
u
u
u
u
u
u
u
u
u
u
"}
(40,1,1) = {"
u
u
u
u
u
u
u
u
u
u
u
u
u
u
u
u
u
u
u
u
u
u
u
u
u
u
u
u
u
u
u
u
u
u
u
u
u
u
u
u
u
u
u
u
u
u
u
u
u
u
"}
(41,1,1) = {"
u
u
u
u
u
u
u
u
u
u
u
u
u
u
u
u
u
u
u
u
u
u
u
u
u
u
u
u
u
u
u
u
u
u
u
u
u
u
u
u
u
u
u
u
u
u
u
u
u
u
"}
(42,1,1) = {"
u
u
u
u
u
u
u
u
u
u
u
u
u
u
u
u
u
u
u
u
u
u
u
u
u
u
u
u
u
u
u
u
u
u
u
u
u
u
u
u
u
u
u
u
u
u
u
u
u
u
"}
(43,1,1) = {"
u
u
u
u
u
u
u
u
u
u
u
u
u
u
u
u
u
u
u
u
u
u
u
u
u
u
u
u
u
u
u
u
u
u
u
u
u
u
u
u
u
u
u
u
u
u
u
u
u
u
"}
(44,1,1) = {"
u
u
u
u
u
u
u
u
u
u
u
u
u
u
u
u
u
u
u
u
u
u
u
u
u
u
u
u
u
u
u
u
u
u
u
u
u
u
u
u
u
u
u
u
u
u
u
u
u
u
"}
(45,1,1) = {"
u
u
u
u
u
u
u
u
u
u
u
u
u
u
u
u
u
u
u
u
u
u
u
u
u
u
u
u
u
u
u
u
u
u
u
u
u
u
u
u
u
u
u
u
u
u
u
u
u
u
"}
(46,1,1) = {"
u
u
u
u
u
u
u
u
u
u
u
u
u
u
u
u
u
u
u
u
u
u
u
u
u
u
u
u
u
u
u
u
u
u
u
u
u
u
u
u
u
u
u
u
u
u
u
u
u
u
"}
(47,1,1) = {"
u
u
u
u
u
u
u
u
u
u
u
u
u
u
u
u
u
u
u
u
u
u
u
u
u
u
u
u
u
u
u
u
u
u
u
u
u
u
u
u
u
u
u
u
u
u
u
u
u
u
"}
(48,1,1) = {"
u
u
u
u
u
u
u
u
u
u
u
u
u
u
u
u
u
u
u
u
u
u
u
u
u
u
u
u
u
u
u
u
u
u
u
u
u
u
u
u
u
u
u
u
u
u
u
u
u
u
"}
(49,1,1) = {"
u
u
u
u
u
u
u
u
u
u
u
u
u
u
u
u
u
u
u
u
u
u
u
u
u
u
u
u
u
u
u
u
u
u
u
u
u
u
u
u
u
u
u
u
u
u
u
u
u
u
"}
(50,1,1) = {"
u
u
u
u
u
u
u
u
u
u
u
u
u
u
u
u
u
u
u
u
u
u
u
u
u
u
u
u
u
u
u
u
u
u
u
u
u
u
u
u
u
u
u
u
u
u
u
u
u
u
"}

(1,1,2) = {"
u
u
u
u
u
u
u
u
u
u
u
u
u
u
u
u
u
u
u
u
u
u
u
u
u
u
u
u
u
u
u
u
u
u
u
u
u
u
u
u
u
u
u
u
u
u
u
u
u
u
"}
(2,1,2) = {"
u
u
u
u
u
u
u
u
u
u
u
u
u
u
u
u
u
u
u
u
u
u
u
u
u
u
u
u
u
u
u
u
u
u
u
u
u
u
u
u
u
u
u
u
u
u
u
u
u
u
"}
(3,1,2) = {"
u
u
u
u
u
u
u
u
u
u
u
u
u
u
u
u
u
u
u
u
u
u
u
u
u
u
u
u
u
u
u
u
u
u
u
u
u
u
u
u
u
u
u
u
u
u
u
u
u
u
"}
(4,1,2) = {"
u
u
u
u
u
u
u
u
u
u
u
u
u
u
u
u
u
u
u
u
u
u
u
u
u
u
u
u
u
u
u
u
u
u
u
u
u
u
u
u
u
u
u
u
u
u
u
u
u
u
"}
(5,1,2) = {"
u
u
u
u
u
u
u
u
u
u
u
u
u
u
u
u
u
u
u
u
u
u
u
u
u
u
u
u
u
u
u
u
u
u
u
u
u
u
u
u
u
u
u
u
u
u
u
u
u
u
"}
(6,1,2) = {"
u
u
u
u
u
u
u
u
u
u
u
u
u
u
u
u
u
u
u
u
u
u
u
u
u
u
u
u
u
u
u
l
l
l
N
N
N
l
l
l
l
l
l
l
u
u
u
u
u
u
"}
(7,1,2) = {"
u
u
u
u
u
u
u
u
u
u
u
u
u
u
u
u
u
u
u
u
u
u
u
u
u
u
u
u
u
u
u
l
l
l
h
h
l
l
l
l
l
l
l
l
u
u
u
u
u
u
"}
(8,1,2) = {"
u
u
u
u
u
u
u
u
u
u
u
u
u
u
u
u
u
u
u
u
u
u
u
u
u
u
u
u
u
u
u
l
l
l
h
l
l
l
l
l
l
l
l
l
u
u
u
u
u
u
"}
(9,1,2) = {"
u
u
u
u
u
u
u
u
u
u
u
u
u
u
u
u
u
u
u
u
u
u
u
u
u
u
u
u
u
u
u
l
l
l
h
l
l
l
l
l
l
l
l
l
u
u
u
u
u
u
"}
(10,1,2) = {"
u
u
u
u
u
u
u
u
u
u
u
u
u
u
u
u
u
u
u
u
u
u
u
u
u
u
u
u
u
u
u
l
l
l
h
l
l
l
l
l
l
l
l
l
u
u
u
u
u
u
"}
(11,1,2) = {"
u
u
u
u
u
u
u
u
H
H
H
H
H
H
H
u
u
u
u
u
u
u
u
u
u
u
u
u
u
u
u
l
l
l
N
N
l
l
l
l
l
l
l
l
u
u
u
u
u
u
"}
(12,1,2) = {"
u
u
u
u
u
u
u
u
H
t
t
t
t
t
H
d
d
u
u
u
k
A
A
A
A
u
u
u
u
u
u
l
l
l
N
N
N
l
l
l
l
l
l
l
u
u
u
u
u
u
"}
(13,1,2) = {"
u
u
u
u
u
u
u
u
H
t
t
t
t
t
H
u
u
u
u
u
A
A
A
A
A
u
u
u
u
u
u
l
l
l
N
N
l
l
l
l
l
l
l
l
u
u
u
u
u
u
"}
(14,1,2) = {"
u
u
u
u
u
u
u
u
H
t
t
t
t
t
H
u
u
u
u
u
A
A
A
A
A
u
u
u
u
u
u
l
l
l
N
l
l
l
l
l
l
l
l
l
u
u
u
u
u
u
"}
(15,1,2) = {"
u
u
u
u
u
u
u
u
H
t
t
t
t
t
H
u
u
u
u
u
A
A
A
A
A
u
u
u
u
u
u
l
l
l
N
l
l
l
l
l
R
l
l
l
u
u
u
u
u
u
"}
(16,1,2) = {"
u
u
u
u
u
u
u
u
H
t
t
t
t
t
t
u
u
u
u
u
A
A
A
A
A
u
u
u
u
u
u
l
l
l
N
N
l
l
l
l
R
l
l
l
u
u
u
u
u
u
"}
(17,1,2) = {"
u
u
u
u
u
u
u
u
H
t
t
t
t
t
H
u
u
u
u
u
A
A
A
A
A
u
u
u
u
u
u
l
l
l
N
N
N
l
l
l
R
l
l
l
u
u
u
u
u
u
"}
(18,1,2) = {"
u
u
u
u
u
u
u
u
H
t
t
t
t
t
H
u
u
m
u
u
A
A
A
A
A
u
u
u
u
u
u
u
u
u
P
P
P
u
u
u
u
u
u
u
u
u
u
u
u
u
"}
(19,1,2) = {"
u
u
u
u
u
u
u
u
H
H
H
H
H
H
H
u
u
u
u
u
A
A
A
A
A
u
u
u
u
u
u
u
u
u
P
P
u
u
u
u
u
u
u
u
u
u
u
u
u
u
"}
(20,1,2) = {"
u
u
u
u
u
u
u
u
H
Z
Z
Z
Z
Z
H
u
u
u
u
u
u
u
u
u
u
u
u
u
u
u
u
u
u
u
P
u
u
u
u
u
u
u
u
u
u
u
u
u
u
u
"}
(21,1,2) = {"
u
u
u
u
u
u
u
u
H
F
Z
Z
Z
Z
Z
u
u
s
u
u
u
u
u
u
u
u
u
u
u
u
u
u
u
u
P
u
u
u
u
u
u
u
u
u
u
u
u
u
u
u
"}
(22,1,2) = {"
u
u
u
u
u
u
u
u
H
Z
Z
Z
Z
Z
H
u
u
u
u
I
I
I
I
I
I
u
u
u
u
u
u
u
u
u
P
P
u
u
u
u
u
u
u
u
u
u
u
u
u
u
"}
(23,1,2) = {"
u
u
u
u
u
u
u
u
H
H
H
H
H
H
H
u
u
u
u
I
I
I
I
I
I
u
u
u
u
u
u
u
u
u
P
P
P
u
u
u
u
u
u
u
u
u
u
u
u
u
"}
(24,1,2) = {"
u
u
u
u
u
u
u
u
H
M
M
M
M
M
p
u
u
u
u
I
I
A
A
I
I
u
u
u
u
u
u
u
u
u
u
u
u
u
u
u
u
u
u
u
u
u
u
u
u
u
"}
(25,1,2) = {"
u
u
u
u
u
u
u
u
H
M
M
M
M
M
p
u
u
u
u
I
I
A
A
I
I
u
u
u
u
u
u
u
u
u
u
u
u
u
u
u
u
u
u
u
u
u
u
u
u
u
"}
(26,1,2) = {"
u
u
u
u
u
u
u
u
H
M
M
M
M
M
p
u
u
u
u
I
I
I
I
I
I
u
u
u
u
u
u
u
u
u
u
u
u
u
u
u
u
u
u
u
u
u
u
u
u
u
"}
(27,1,2) = {"
u
u
u
u
u
u
u
u
H
M
M
M
M
M
p
u
u
u
u
I
I
I
I
I
I
u
u
u
u
u
u
u
u
u
u
u
u
u
u
u
u
u
u
u
u
u
u
u
u
u
"}
(28,1,2) = {"
u
u
u
u
u
u
u
u
H
H
H
H
H
H
H
u
u
u
u
u
u
u
u
u
u
u
u
u
u
u
u
u
u
u
u
u
u
u
u
u
u
u
u
u
u
u
u
u
u
u
"}
(29,1,2) = {"
u
u
u
u
u
u
u
u
H
L
L
L
L
L
H
u
u
u
u
O
O
O
O
O
O
u
u
u
u
u
u
u
u
u
u
u
u
u
u
u
u
u
u
u
u
u
u
u
u
u
"}
(30,1,2) = {"
u
u
u
u
u
u
u
u
H
L
L
L
L
L
H
u
u
u
u
O
v
v
v
v
O
u
u
u
u
u
u
u
u
u
u
u
u
u
u
u
u
u
u
u
u
u
u
u
u
u
"}
(31,1,2) = {"
u
u
u
u
u
u
u
u
H
L
L
L
L
L
L
u
u
u
u
v
v
v
v
v
O
u
u
u
u
u
u
u
u
u
u
u
u
u
u
u
u
u
u
u
u
u
u
u
u
u
"}
(32,1,2) = {"
u
u
u
u
u
u
u
u
H
L
L
L
L
L
H
u
u
u
u
v
v
v
v
v
O
u
u
u
u
u
u
u
u
u
u
u
u
u
u
u
u
u
u
u
u
u
u
u
u
u
"}
(33,1,2) = {"
u
u
u
u
u
u
u
u
H
H
H
H
H
H
H
u
u
u
u
O
v
v
v
v
O
u
u
u
u
u
u
u
u
u
u
u
u
u
u
u
u
u
u
u
u
u
u
u
u
u
"}
(34,1,2) = {"
u
u
u
u
u
u
u
u
I
B
B
B
B
B
I
u
u
u
u
O
v
v
v
v
O
u
u
u
u
u
u
u
u
u
u
u
u
u
u
u
u
u
u
u
u
u
u
u
u
u
"}
(35,1,2) = {"
u
u
u
u
u
u
u
u
I
B
B
B
B
B
I
u
u
u
u
O
v
v
v
v
O
u
u
u
u
u
u
u
u
u
u
u
u
u
u
u
u
u
u
u
u
u
u
u
u
u
"}
(36,1,2) = {"
u
u
u
u
u
u
u
u
I
B
B
B
B
B
I
u
u
u
u
O
v
v
v
v
O
u
u
u
u
u
u
u
u
u
u
u
u
u
u
u
u
u
u
u
u
u
u
u
u
u
"}
(37,1,2) = {"
u
u
u
u
u
u
u
u
I
B
B
B
B
B
I
u
u
u
u
O
v
v
v
v
O
u
u
u
u
u
u
u
u
u
u
u
u
u
u
u
u
u
u
u
u
u
u
u
u
u
"}
(38,1,2) = {"
u
u
u
u
u
u
u
u
I
B
B
B
B
B
I
u
u
u
u
O
v
v
v
v
O
u
u
u
u
u
u
u
u
u
u
u
u
u
u
u
u
u
u
u
u
u
u
u
u
u
"}
(39,1,2) = {"
u
u
u
u
u
u
u
u
I
B
B
B
B
B
I
u
u
u
u
O
v
v
v
v
O
u
u
u
u
u
u
u
u
u
u
u
u
u
u
u
u
u
u
u
u
u
u
u
u
u
"}
(40,1,2) = {"
u
u
u
u
u
u
u
u
I
I
I
I
I
I
I
u
u
u
u
O
v
v
v
v
O
u
u
u
u
u
u
u
u
u
u
u
u
u
u
u
u
u
u
u
u
u
u
u
u
u
"}
(41,1,2) = {"
u
u
u
u
u
u
u
u
u
u
u
u
u
u
u
u
u
u
u
O
O
O
O
O
O
u
u
u
u
u
u
u
u
u
u
u
u
u
u
u
u
u
u
u
u
u
u
u
u
u
"}
(42,1,2) = {"
u
u
u
u
u
u
u
u
u
u
u
u
u
u
u
u
u
u
u
u
u
u
u
u
u
u
u
u
u
u
u
u
u
u
u
u
u
u
u
u
u
u
u
u
u
u
u
u
u
u
"}
(43,1,2) = {"
u
u
u
u
u
u
u
u
u
u
u
u
u
u
u
u
u
u
u
u
u
u
u
u
u
u
u
u
u
u
u
u
u
u
u
u
u
u
u
u
u
u
u
u
u
u
u
u
u
u
"}
(44,1,2) = {"
u
u
u
u
u
u
u
u
u
u
u
u
u
u
u
u
u
u
u
u
u
u
u
u
u
u
u
u
u
u
u
u
u
u
u
u
u
u
u
u
u
u
u
u
u
u
u
u
u
u
"}
(45,1,2) = {"
u
u
u
u
u
u
u
u
u
u
u
u
u
u
u
u
u
u
u
u
u
u
u
u
u
u
u
u
u
u
u
u
u
u
u
u
u
u
u
u
u
u
u
u
u
u
u
u
u
u
"}
(46,1,2) = {"
u
u
u
u
u
u
u
u
u
u
u
u
u
u
u
u
u
u
u
u
u
u
u
u
u
u
u
u
u
u
u
u
u
u
u
u
u
u
u
u
u
u
u
u
u
u
u
u
u
u
"}
(47,1,2) = {"
u
u
u
u
u
u
u
u
u
u
u
u
u
u
u
u
u
u
u
u
u
u
u
u
u
u
u
u
u
u
u
u
u
u
u
u
u
u
u
u
u
u
u
u
u
u
u
u
u
u
"}
(48,1,2) = {"
u
u
u
u
u
u
u
u
u
u
u
u
u
u
u
u
u
u
u
u
u
u
u
u
u
u
u
u
u
u
u
u
u
u
u
u
u
u
u
u
u
u
u
u
u
u
u
u
u
u
"}
(49,1,2) = {"
u
u
u
u
u
u
u
u
u
u
u
u
u
u
u
u
u
u
u
u
u
u
u
u
u
u
u
u
u
u
u
u
u
u
u
u
u
u
u
u
u
u
u
u
u
u
u
u
u
u
"}
(50,1,2) = {"
u
u
u
u
u
u
u
u
u
u
u
u
u
u
u
u
u
u
u
u
u
u
u
u
u
u
u
u
u
u
u
u
u
u
u
u
u
u
u
u
u
u
u
u
u
u
u
u
u
u
"}

(1,1,3) = {"
A
A
A
A
A
A
A
A
A
A
A
A
A
A
A
A
A
A
A
A
A
A
A
A
A
A
A
A
A
A
A
A
A
A
A
A
A
A
A
A
A
A
A
A
A
A
A
A
A
A
"}
(2,1,3) = {"
A
A
A
A
A
A
A
A
A
A
A
A
A
A
A
A
A
A
A
A
A
A
A
A
A
A
A
A
A
A
A
A
A
A
A
A
A
A
A
A
A
A
A
A
A
A
A
A
A
A
"}
(3,1,3) = {"
A
A
A
A
A
A
A
A
A
A
A
A
A
A
A
A
A
A
A
A
A
A
A
A
A
A
A
A
A
A
A
A
A
A
A
A
A
A
A
A
A
A
A
A
A
A
A
A
A
A
"}
(4,1,3) = {"
A
A
A
A
A
A
A
A
A
A
A
A
A
A
A
A
A
A
A
A
A
A
A
A
A
A
A
A
A
A
A
A
A
A
A
A
A
A
A
A
A
A
A
A
A
A
A
A
A
A
"}
(5,1,3) = {"
A
A
A
A
A
A
A
A
A
A
A
A
A
A
A
A
A
A
A
A
A
A
A
A
A
A
A
A
A
A
A
A
A
A
A
A
A
A
A
A
A
A
A
A
A
A
A
A
A
A
"}
(6,1,3) = {"
A
A
A
A
A
A
A
A
A
A
A
A
A
A
A
A
A
A
A
A
A
A
A
A
A
A
A
A
A
A
A
A
A
A
A
A
A
A
A
A
A
A
A
A
A
A
A
A
A
A
"}
(7,1,3) = {"
A
A
A
A
A
A
A
A
A
A
A
A
A
A
A
A
A
A
A
A
A
A
A
A
A
A
A
A
A
A
A
A
A
A
A
A
A
A
A
A
A
A
A
A
A
A
A
A
A
A
"}
(8,1,3) = {"
A
A
A
A
A
A
A
A
A
A
A
A
A
A
A
A
A
A
A
A
A
A
A
A
A
A
A
A
A
A
A
A
A
A
A
A
A
A
A
A
A
A
A
A
A
A
A
A
A
A
"}
(9,1,3) = {"
A
A
A
A
A
A
A
A
A
A
A
A
A
A
A
A
A
A
A
A
A
A
A
A
A
A
A
A
A
A
A
A
A
A
A
A
A
A
A
A
A
A
A
A
A
A
A
A
A
A
"}
(10,1,3) = {"
A
A
A
A
A
A
A
A
A
A
A
A
A
A
A
A
A
A
A
A
A
A
A
A
A
A
A
A
A
A
A
A
A
A
A
A
A
A
A
A
A
A
A
A
A
A
A
A
A
A
"}
(11,1,3) = {"
A
A
A
A
A
A
A
A
K
K
K
K
K
K
K
A
A
A
A
A
A
A
A
A
A
A
A
A
A
A
A
A
A
A
A
A
A
A
A
A
A
A
A
A
A
A
A
A
A
A
"}
(12,1,3) = {"
A
A
A
A
A
A
A
A
K
K
K
K
K
K
K
S
A
A
A
A
A
A
A
A
A
A
A
A
A
A
A
A
A
A
A
A
A
A
A
A
A
A
A
A
A
A
A
A
A
A
"}
(13,1,3) = {"
A
A
A
A
A
A
A
A
K
K
K
K
K
K
K
A
A
A
A
A
A
A
A
A
A
A
A
A
A
A
A
A
A
A
A
A
A
A
A
A
A
A
A
A
A
A
A
A
A
A
"}
(14,1,3) = {"
A
A
A
A
A
A
A
A
K
K
K
K
K
K
K
A
A
A
A
A
A
A
A
A
A
A
A
A
A
A
A
A
A
A
A
A
A
A
A
A
A
A
A
A
A
A
A
A
A
A
"}
(15,1,3) = {"
A
A
A
A
A
A
A
A
K
K
K
K
K
K
K
A
A
A
A
A
A
A
A
A
A
A
A
A
A
A
A
A
A
A
A
A
A
A
A
A
A
A
A
A
A
A
A
A
A
A
"}
(16,1,3) = {"
A
A
A
A
A
A
A
A
K
K
K
K
K
K
K
A
A
A
A
A
A
A
A
A
A
A
A
A
A
A
A
A
A
A
A
A
A
A
A
A
A
A
A
A
A
A
A
A
A
A
"}
(17,1,3) = {"
A
A
A
A
A
A
A
A
K
K
K
K
K
K
K
A
A
A
A
A
A
A
A
A
A
A
A
A
A
A
A
A
A
A
A
A
A
A
A
A
A
A
A
A
A
A
A
A
A
A
"}
(18,1,3) = {"
A
A
A
A
A
A
A
A
K
K
K
K
K
K
K
A
A
A
A
A
A
A
A
A
A
A
A
A
A
A
A
A
A
A
A
A
A
A
A
A
A
A
A
A
A
A
A
A
A
A
"}
(19,1,3) = {"
A
A
A
A
A
A
A
A
K
K
K
K
K
K
K
A
A
A
A
A
A
A
A
A
A
A
A
A
A
A
A
A
A
A
A
A
A
A
A
A
A
A
A
A
A
A
A
A
A
A
"}
(20,1,3) = {"
A
A
A
A
A
A
A
A
K
K
K
K
K
K
K
A
A
A
A
A
A
A
A
A
A
A
A
A
A
A
A
A
A
A
A
A
A
A
A
A
A
A
A
A
A
A
A
A
A
A
"}
(21,1,3) = {"
A
A
A
A
A
A
A
A
K
K
K
K
K
K
K
A
A
A
A
A
A
A
A
A
A
A
A
A
A
A
A
A
A
A
A
A
A
A
A
A
A
A
A
A
A
A
A
A
A
A
"}
(22,1,3) = {"
A
A
A
A
A
A
A
A
K
K
K
K
K
K
K
A
A
A
A
A
A
A
A
A
A
A
A
A
A
A
A
A
A
A
A
A
A
A
A
A
A
A
A
A
A
A
A
A
A
A
"}
(23,1,3) = {"
A
A
A
A
A
A
A
A
K
K
K
K
K
K
K
A
A
A
A
A
K
K
K
K
A
A
A
A
A
A
A
A
A
A
A
A
A
A
A
A
A
A
A
A
A
A
A
A
A
A
"}
(24,1,3) = {"
A
A
A
A
A
A
A
A
K
K
K
K
K
K
K
A
A
A
A
A
K
K
K
K
A
A
A
A
A
A
A
A
A
A
A
A
A
A
A
A
A
A
A
A
A
A
A
A
A
A
"}
(25,1,3) = {"
A
A
A
A
A
A
A
A
K
K
K
K
K
K
K
A
A
A
A
A
K
K
K
K
A
A
A
A
A
A
A
A
A
A
A
A
A
A
A
A
A
A
A
A
A
A
A
A
A
A
"}
(26,1,3) = {"
A
A
A
A
A
A
A
A
K
K
K
K
K
K
K
A
A
A
A
A
K
K
K
K
A
A
A
A
A
A
A
A
A
A
A
A
A
A
A
A
A
A
A
A
A
A
A
A
A
A
"}
(27,1,3) = {"
A
A
A
A
A
A
A
A
K
K
K
K
K
K
K
A
A
A
A
A
A
K
K
A
A
A
A
A
A
A
A
A
A
A
A
A
A
A
A
A
A
A
A
A
A
A
A
A
A
A
"}
(28,1,3) = {"
A
A
A
A
A
A
A
A
K
K
K
K
K
K
K
A
A
A
A
A
A
K
K
A
A
A
A
A
A
A
A
A
A
A
A
A
A
A
A
A
A
A
A
A
A
A
A
A
A
A
"}
(29,1,3) = {"
A
A
A
A
A
A
A
A
K
K
K
K
K
K
K
A
A
A
A
K
K
K
K
K
K
A
A
A
A
A
A
A
A
A
A
A
A
A
A
A
A
A
A
A
A
A
A
A
A
A
"}
(30,1,3) = {"
A
A
A
A
A
A
A
A
K
K
K
K
K
K
K
A
A
A
A
K
K
K
K
K
K
A
A
A
A
A
A
A
A
A
A
A
A
A
A
A
A
A
A
A
A
A
A
A
A
A
"}
(31,1,3) = {"
A
A
A
A
A
A
A
A
K
K
K
K
K
K
K
A
A
A
A
K
K
K
K
K
K
A
A
A
A
A
A
A
A
A
A
A
A
A
A
A
A
A
A
A
A
A
A
A
A
A
"}
(32,1,3) = {"
A
A
A
A
A
A
A
A
K
K
K
K
K
K
K
A
A
A
A
K
K
K
K
K
K
A
A
A
A
A
A
A
A
A
A
A
A
A
A
A
A
A
A
A
A
A
A
A
A
A
"}
(33,1,3) = {"
A
A
A
A
A
A
A
A
K
K
K
K
K
K
K
A
A
A
A
K
K
K
K
K
K
A
A
A
A
A
A
A
A
A
A
A
A
A
A
A
A
A
A
A
A
A
A
A
A
A
"}
(34,1,3) = {"
A
A
A
A
A
A
A
A
K
K
K
K
K
K
K
A
A
A
A
K
K
K
K
K
K
A
A
A
A
A
A
A
A
A
A
A
A
A
A
A
A
A
A
A
A
A
A
A
A
A
"}
(35,1,3) = {"
A
A
A
A
A
A
A
A
K
K
K
K
K
K
K
K
K
K
K
K
K
K
K
K
K
A
A
A
A
A
A
A
A
A
A
A
A
A
A
A
A
A
A
A
A
A
A
A
A
A
"}
(36,1,3) = {"
A
A
A
A
A
A
A
A
K
K
K
K
K
K
K
A
A
A
A
K
K
K
K
K
K
A
A
A
A
A
A
A
A
A
A
A
A
A
A
A
A
A
A
A
A
A
A
A
A
A
"}
(37,1,3) = {"
A
A
A
A
A
A
A
A
K
K
K
K
K
K
K
A
A
A
A
K
K
K
K
K
K
A
A
A
A
A
A
A
A
A
A
A
A
A
A
A
A
A
A
A
A
A
A
A
A
A
"}
(38,1,3) = {"
A
A
A
A
A
A
A
A
K
K
K
K
K
K
K
A
A
A
A
K
K
A
A
K
K
A
A
A
A
A
A
A
A
A
A
A
A
A
A
A
A
A
A
A
A
A
A
A
A
A
"}
(39,1,3) = {"
A
A
A
A
A
A
A
A
K
K
K
K
K
K
K
A
A
A
A
K
K
A
A
K
K
A
A
A
A
A
A
A
A
A
A
A
A
A
A
A
A
A
A
A
A
A
A
A
A
A
"}
(40,1,3) = {"
A
A
A
A
A
A
A
A
K
K
K
K
K
K
K
A
A
A
A
K
K
K
K
K
K
A
A
A
A
A
A
A
A
A
A
A
A
A
A
A
A
A
A
A
A
A
A
A
A
A
"}
(41,1,3) = {"
A
A
A
A
A
A
A
A
A
A
A
A
A
A
A
A
A
A
A
K
K
K
K
K
K
A
A
A
A
A
A
A
A
A
A
A
A
A
A
A
A
A
A
A
A
A
A
A
A
A
"}
(42,1,3) = {"
A
A
A
A
A
A
A
A
A
A
A
A
A
A
A
A
A
A
A
A
A
A
A
A
A
A
A
A
A
A
A
A
A
A
A
A
A
A
A
A
A
A
A
A
A
A
A
A
A
A
"}
(43,1,3) = {"
A
A
A
A
A
A
A
A
A
A
A
A
A
A
A
A
A
A
A
A
A
A
A
A
A
A
A
A
A
A
A
A
A
A
A
A
A
A
A
A
A
A
A
A
A
A
A
A
A
A
"}
(44,1,3) = {"
A
A
A
A
A
A
A
A
A
A
A
A
A
A
A
A
A
A
A
A
A
A
A
A
A
A
A
A
A
A
A
A
A
A
A
A
A
A
A
A
A
A
A
A
A
A
A
A
A
A
"}
(45,1,3) = {"
A
A
A
A
A
A
A
A
A
A
A
A
A
A
A
A
A
A
A
A
A
A
A
A
A
A
A
A
A
A
A
A
A
A
A
A
A
A
A
A
A
A
A
A
A
A
A
A
A
A
"}
(46,1,3) = {"
A
A
A
A
A
A
A
A
A
A
A
A
A
A
A
A
A
A
A
A
A
A
A
A
A
A
A
A
A
A
A
A
A
A
A
A
A
A
A
A
A
A
A
A
A
A
A
A
A
A
"}
(47,1,3) = {"
A
A
A
A
A
A
A
A
A
A
A
A
A
A
A
A
A
A
A
A
A
A
A
A
A
A
A
A
A
A
A
A
A
A
A
A
A
A
A
A
A
A
A
A
A
A
A
A
A
A
"}
(48,1,3) = {"
A
A
A
A
A
A
A
A
A
A
A
A
A
A
A
A
A
A
A
A
A
A
A
A
A
A
A
A
A
A
A
A
A
A
A
A
A
A
A
A
A
A
A
A
A
A
A
A
A
A
"}
(49,1,3) = {"
A
A
A
A
A
A
A
A
A
A
A
A
A
A
A
A
A
A
A
A
A
A
A
A
A
A
A
A
A
A
A
A
A
A
A
A
A
A
A
A
A
A
A
A
A
A
A
A
A
A
"}
(50,1,3) = {"
A
A
A
A
A
A
A
A
A
A
A
A
A
A
A
A
A
A
A
A
A
A
A
A
A
A
A
A
A
A
A
A
A
A
A
A
A
A
A
A
A
A
A
A
A
A
A
A
A
A
"}
