"d" = (/obj/structure/stairs,/turf/open/floor/grass,/area/hallway/primary/central)
"h" = (/turf/closed/indestructible/rock/ms13/mammoth,/area/hallway/primary/central)
"k" = (/obj/structure/stairs,/turf/open/floor/iron/stairs,/area/hallway/primary/central)
"l" = (/turf/open/floor/plating/ms13/ground/snow,/area/hallway/primary/central)
"m" = (/obj/effect/landmark/start/assistant,/turf/open/floor/plating/ms13/ground/desert,/area/hallway/primary/central)
"p" = (/obj/effect/spawner/structure/window,/turf/open/floor/iron/ms13/concrete,/area/hallway/primary/central)
"s" = (/obj/effect/landmark/observer_start,/turf/open/floor/plating/ms13/ground/desert,/area/hallway/primary/central)
"t" = (/turf/open/floor/iron/ms13/ceramic,/area/hallway/primary/central)
"u" = (/turf/open/floor/plating/ms13/ground/desert,/area/hallway/primary/central)
"v" = (/turf/open/floor/iron/ms13/brick,/area/hallway/primary/central)
"A" = (/turf/open/openspace,/area/hallway/primary/central)
"B" = (/turf/open/floor/plating/ms13,/area/hallway/primary/central)
"F" = (/obj/machinery/light/cold/directional/north,/turf/open/floor/iron/ms13/concrete/industrial/alt,/area/hallway/primary/central)
"H" = (/turf/closed/wall/r_wall/ms13/bunker,/area/hallway/primary/central)
"I" = (/turf/open/floor/iron/ms13/ceramic/ornate,/area/hallway/primary/central)
"K" = (/turf/open/floor/bronze,/area/hallway/primary/central)
"L" = (/turf/open/floor/iron/ms13/metal,/area/hallway/primary/central)
"M" = (/turf/open/floor/iron/ms13/concrete,/area/hallway/primary/central)
"N" = (/turf/closed/indestructible/rock/ms13,/area/hallway/primary/central)
"O" = (/turf/closed/wall,/area/hallway/primary/central)
"P" = (/turf/closed/indestructible/rock/ms13/drought,/area/hallway/primary/central)
"R" = (/turf/closed/indestructible/ms13/comb,/area/hallway/primary/central)
"S" = (/turf/open/floor/iron/stairs,/area/hallway/primary/central)
"Z" = (/turf/open/floor/iron/ms13/concrete/industrial/alt,/area/hallway/primary/central)

(1,1,1) = {"
uuuuuuuuuuuuuuuuuuuuuuuuuuuuuuuuuuuuuuuuuuuuuuuuuu
uuuuuuuuuuuuuuuuuuuuuuuuuuuuuuuuuuuuuuuuuuuuuuuuuu
uuuuuuuuuuuuuuuuuuuuuuuuuuuuuuuuuuuuuuuuuuuuuuuuuu
uuuuuuuuuuuuuuuuuuuuuuuuuuuuuuuuuuuuuuuuuuuuuuuuuu
uuuuuuuuuuuuuuuuuuuuuuuuuuuuuuuuuuuuuuuuuuuuuuuuuu
uuuuuuuuuuuuuuuuuuuuuuuuuuuuuuuuuuuuuuuuuuuuuuuuuu
uuuuuuuuuuuuuuuuuuuuuuuuuuuuuuuuuuuuuuuuuuuuuuuuuu
uuuuuuuuuuuuuuuuuuuuuuuuuuuuuuuuuuuuuuuuuuuuuuuuuu
uuuuuuuuuuuuuuuuuuuuuuuuuuuuuuuuuuuuuuuuuuuuuuuuuu
uuuuuuuuuuuuuuuuuuuuuuuuuuuuuuuuuuuuuuuuuuuuuuuuuu
uuuuuuuuuuuuuuuuuuuuuuuuuuuuuuuuuuuuuuuuuuuuuuuuuu
uuuuuuuuuuuuuuuuuuuuuuuuuuuuuuuuuuuuuuuuuuuuuuuuuu
uuuuuuuuuuuuuuuuuuuuuuuuuuuuuuuuuuuuuuuuuuuuuuuuuu
uuuuuuuuuuuuuuuuuuuuuuuuuuuuuuuuuuuuuuuuuuuuuuuuuu
uuuuuuuuuuuuuuuuuuuuuuuuuuuuuuuuuuuuuuuuuuuuuuuuuu
uuuuuuuuuuuuuuuuuuuuuuuuuuuuuuuuuuuuuuuuuuuuuuuuuu
uuuuuuuuuuuuuuuuuuuuuuuuuuuuuuuuuuuuuuuuuuuuuuuuuu
uuuuuuuuuuuuuuuuuuuuuuuuuuuuuuuuuuuuuuuuuuuuuuuuuu
uuuuuuuuuuuuuuuuuuuuuuuuuuuuuuuuuuuuuuuuuuuuuuuuuu
uuuuuuuuuuuuuuuuuuuuuuuuuuuuuuuuuuuuuuuuuuuuuuuuuu
uuuuuuuuuuuduuuuuuuuuuuuuuuuuuuuuuuuuuuuuuuuuuuuuu
uuuuuuuuuuuduuuuuuuuuuuuuuuuuuuuuuuuuuuuuuuuuuuuuu
uuuuuuuuuuuuuuuuuuuuuuuuuuuuuuuuuuuuuuuuuuuuuuuuuu
uuuuuuuuuuuuuuuuuuuuuuuuuuuuuuuuuuuuuuuuuuuuuuuuuu
uuuuuuuuuuuuuuuuuuuuuuuuuuuuuuuuuuuuuuuuuuuuuuuuuu
uuuuuuuuuuuuuuuuuuuuuuuuuuuuuuuuuuuuuuuuuuuuuuuuuu
uuuuuuuuuuuuuuuuuuuuuuuuuuuuuuuuuuuuuuuuuuuuuuuuuu
uuuuuuuuuuuuuuuuuuuuuuuuuuuuuuuuuuuuuuuuuuuuuuuuuu
uuuuuuuuuuuuuuuuuuuuuuuuuuuuuuuuuuuuuuuuuuuuuuuuuu
uuuuuuuuuuuuuuuuuuuuuuuuuuuuuuuuuuuuuuuuuuuuuuuuuu
uuuuuuuuuuuuuuuuuuuuuuuuuuuuuuuuuuuuuuuuuuuuuuuuuu
uuuuuuuuuuuuuuuuuuuuuuuuuuuuuuuuuuuuuuuuuuuuuuuuuu
uuuuuuuuuuuuuuuuuuuuuuuuuuuuuuuuuuuuuuuuuuuuuuuuuu
uuuuuuuuuuuuuuuuuuuuuuuuuuuuuuuuuuuuuuuuuuuuuuuuuu
uuuuuuuuuuuuuuuuuuuuuuuuuuuuuuuuuuuuuuuuuuuuuuuuuu
uuuuuuuuuuuuuuuuuuuuuuuuuuuuuuuuuuuuuuuuuuuuuuuuuu
uuuuuuuuuuuuuuuuuuuuuuuuuuuuuuuuuuuuuuuuuuuuuuuuuu
uuuuuuuuuuuuuuuuuuuuuuuuuuuuuuuuuuuuuuuuuuuuuuuuuu
uuuuuuuuuuuuuuuuuuuuuuuuuuuuuuuuuuuuuuuuuuuuuuuuuu
uuuuuuuuuuuuuuuuuuuuuuuuuuuuuuuuuuuuuuuuuuuuuuuuuu
uuuuuuuuuuuuuuuuuuuuuuuuuuuuuuuuuuuuuuuuuuuuuuuuuu
uuuuuuuuuuuuuuuuuuuuuuuuuuuuuuuuuuuuuuuuuuuuuuuuuu
uuuuuuuuuuuuuuuuuuuuuuuuuuuuuuuuuuuuuuuuuuuuuuuuuu
uuuuuuuuuuuuuuuuuuuuuuuuuuuuuuuuuuuuuuuuuuuuuuuuuu
uuuuuuuuuuuuuuuuuuuuuuuuuuuuuuuuuuuuuuuuuuuuuuuuuu
uuuuuuuuuuuuuuuuuuuuuuuuuuuuuuuuuuuuuuuuuuuuuuuuuu
uuuuuuuuuuuuuuuuuuuuuuuuuuuuuuuuuuuuuuuuuuuuuuuuuu
uuuuuuuuuuuuuuuuuuuuuuuuuuuuuuuuuuuuuuuuuuuuuuuuuu
uuuuuuuuuuuuuuuuuuuuuuuuuuuuuuuuuuuuuuuuuuuuuuuuuu
uuuuuuuuuuuuuuuuuuuuuuuuuuuuuuuuuuuuuuuuuuuuuuuuuu
"}
(1,1,2) = {"
uuuuuuuuuuuuuuuuuuuuuuuuuuuuuuuuuuuuuuuuuuuuuuuuuu
uuuuuuuuuuuuuuuuuuuuuuuuuuuuuuuuuuuuuuuuuuuuuuuuuu
uuuuuuuuuuuuuuuuuuuuuuuuuuuuuuuuuuuuuuuuuuuuuuuuuu
uuuuuuuuuuuuuuuuuuuuuuuuuuuuuuuuuuuuuuuuuuuuuuuuuu
uuuuuuuuuuuuuuuuuuuuuuuuuuuuuuuuuuuuuuuuuuuuuuuuuu
uuuuuuuuuuuuuuuuuuuuuuuuuuuuuuuuuuuuuuuuuuuuuuuuuu
uuuuuuuuuuuuuuuuuuuuuuuuuuuuuuuuuuuuuuuuuuuuuuuuuu
uuuuuuuuuuuuuuuuuuuuuuuuuuuuuuuuuuuuuuuuuuuuuuuuuu
uuuuuuuuuuHHHHHHHHHHHHHHHHHHHHHHHIIIIIIIuuuuuuuuuu
uuuuuuuuuuHtttttttHZFZHMMMMHLLLLHBBBBBBIuuuuuuuuuu
uuuuuuuuuuHtttttttHZZZHMMMMHLLLLHBBBBBBIuuuuuuuuuu
uuuuuuuuuuHtttttttHZZZHMMMMHLLLLHBBBBBBIuuuuuuuuuu
uuuuuuuuuuHtttttttHZZZHMMMMHLLLLHBBBBBBIuuuuuuuuuu
uuuuuuuuuuHtttttttHZZZHMMMMHLLLLHBBBBBBIuuuuuuuuuu
uuuuuuuuuuHHHHHtHHHHZHHppppHHHLHHIIIIIIIuuuuuuuuuu
uuuuuuuuuuuduuuuuuuuuuuuuuuuuuuuuuuuuuuuuuuuuuuuuu
uuuuuuuuuuuduuuuuuuuuuuuuuuuuuuuuuuuuuuuuuuuuuuuuu
uuuuuuuuuuuuuuuuumuusuuuuuuuuuuuuuuuuuuuuuuuuuuuuu
uuuuuuuuuuuuuuuuuuuuuuuuuuuuuuuuuuuuuuuuuuuuuuuuuu
uuuuuuuuuuuuuuuuuuuuuIIIIIIuOOvvOOOOOOOOOuuuuuuuuu
uuuuuuuuuuukAAAAAAAuuIIIIIIuOvvvvvvvvvvvOuuuuuuuuu
uuuuuuuuuuuAAAAAAAAuuIIAAIIuOvvvvvvvvvvvOuuuuuuuuu
uuuuuuuuuuuAAAAAAAAuuIIAAIIuOvvvvvvvvvvvOuuuuuuuuu
uuuuuuuuuuuAAAAAAAAuuIIIIIIuOvvvvvvvvvvvOuuuuuuuuu
uuuuuuuuuuuAAAAAAAAuuIIIIIIuOOOOOOOOOOOOOuuuuuuuuu
uuuuuuuuuuuuuuuuuuuuuuuuuuuuuuuuuuuuuuuuuuuuuuuuuu
uuuuuuuuuuuuuuuuuuuuuuuuuuuuuuuuuuuuuuuuuuuuuuuuuu
uuuuuuuuuuuuuuuuuuuuuuuuuuuuuuuuuuuuuuuuuuuuuuuuuu
uuuuuuuuuuuuuuuuuuuuuuuuuuuuuuuuuuuuuuuuuuuuuuuuuu
uuuuuuuuuuuuuuuuuuuuuuuuuuuuuuuuuuuuuuuuuuuuuuuuuu
uuuuuuuuuuuuuuuuuuuuuuuuuuuuuuuuuuuuuuuuuuuuuuuuuu
uuuuulllllllllllluuuuuuuuuuuuuuuuuuuuuuuuuuuuuuuuu
uuuuulllllllllllluuuuuuuuuuuuuuuuuuuuuuuuuuuuuuuuu
uuuuulllllllllllluuuuuuuuuuuuuuuuuuuuuuuuuuuuuuuuu
uuuuuNhhhhNNNNNNNPPPPPPuuuuuuuuuuuuuuuuuuuuuuuuuuu
uuuuuNhlllNNNllNNPPuuPPuuuuuuuuuuuuuuuuuuuuuuuuuuu
uuuuuNlllllNllllNPuuuuPuuuuuuuuuuuuuuuuuuuuuuuuuuu
uuuuulllllllllllluuuuuuuuuuuuuuuuuuuuuuuuuuuuuuuuu
uuuuulllllllllllluuuuuuuuuuuuuuuuuuuuuuuuuuuuuuuuu
uuuuulllllllllllluuuuuuuuuuuuuuuuuuuuuuuuuuuuuuuuu
uuuuulllllllllRRRuuuuuuuuuuuuuuuuuuuuuuuuuuuuuuuuu
uuuuulllllllllllluuuuuuuuuuuuuuuuuuuuuuuuuuuuuuuuu
uuuuulllllllllllluuuuuuuuuuuuuuuuuuuuuuuuuuuuuuuuu
uuuuulllllllllllluuuuuuuuuuuuuuuuuuuuuuuuuuuuuuuuu
uuuuuuuuuuuuuuuuuuuuuuuuuuuuuuuuuuuuuuuuuuuuuuuuuu
uuuuuuuuuuuuuuuuuuuuuuuuuuuuuuuuuuuuuuuuuuuuuuuuuu
uuuuuuuuuuuuuuuuuuuuuuuuuuuuuuuuuuuuuuuuuuuuuuuuuu
uuuuuuuuuuuuuuuuuuuuuuuuuuuuuuuuuuuuuuuuuuuuuuuuuu
uuuuuuuuuuuuuuuuuuuuuuuuuuuuuuuuuuuuuuuuuuuuuuuuuu
uuuuuuuuuuuuuuuuuuuuuuuuuuuuuuuuuuuuuuuuuuuuuuuuuu
"}
(1,1,3) = {"
AAAAAAAAAAAAAAAAAAAAAAAAAAAAAAAAAAAAAAAAAAAAAAAAAA
AAAAAAAAAAAAAAAAAAAAAAAAAAAAAAAAAAAAAAAAAAAAAAAAAA
AAAAAAAAAAAAAAAAAAAAAAAAAAAAAAAAAAAAAAAAAAAAAAAAAA
AAAAAAAAAAAAAAAAAAAAAAAAAAAAAAAAAAAAAAAAAAAAAAAAAA
AAAAAAAAAAAAAAAAAAAAAAAAAAAAAAAAAAAAAAAAAAAAAAAAAA
AAAAAAAAAAAAAAAAAAAAAAAAAAAAAAAAAAAAAAAAAAAAAAAAAA
AAAAAAAAAAAAAAAAAAAAAAAAAAAAAAAAAAAAAAAAAAAAAAAAAA
AAAAAAAAAAAAAAAAAAAAAAAAAAAAAAAAAAAAAAAAAAAAAAAAAA
AAAAAAAAAAKKKKKKKKKKKKKKKKKKKKKKKKKKKKKKAAAAAAAAAA
AAAAAAAAAAKKKKKKKKKKKKKKKKKKKKKKKKKKKKKKAAAAAAAAAA
AAAAAAAAAAKKKKKKKKKKKKKKKKKKKKKKKKKKKKKKAAAAAAAAAA
AAAAAAAAAAKKKKKKKKKKKKKKKKKKKKKKKKKKKKKKAAAAAAAAAA
AAAAAAAAAAKKKKKKKKKKKKKKKKKKKKKKKKKKKKKKAAAAAAAAAA
AAAAAAAAAAKKKKKKKKKKKKKKKKKKKKKKKKKKKKKKAAAAAAAAAA
AAAAAAAAAAKKKKKKKKKKKKKKKKKKKKKKKKKKKKKKAAAAAAAAAA
AAAAAAAAAAASAAAAAAAAAAAAAAAAAAAAAAKAAAAAAAAAAAAAAA
AAAAAAAAAAAAAAAAAAAAAAAAAAAAAAAAAAKAAAAAAAAAAAAAAA
AAAAAAAAAAAAAAAAAAAAAAAAAAAAAAAAAAKAAAAAAAAAAAAAAA
AAAAAAAAAAAAAAAAAAAAAAAAAAAAAAAAAAKAAAAAAAAAAAAAAA
AAAAAAAAAAAAAAAAAAAAAAAAAAAAKKKKKKKKKKKKKAAAAAAAAA
AAAAAAAAAAAAAAAAAAAAAAKKKKAAKKKKKKKKKKKKKAAAAAAAAA
AAAAAAAAAAAAAAAAAAAAAAKKKKKKKKKKKKKKKAAKKAAAAAAAAA
AAAAAAAAAAAAAAAAAAAAAAKKKKKKKKKKKKKKKAAKKAAAAAAAAA
AAAAAAAAAAAAAAAAAAAAAAKKKKAAKKKKKKKKKKKKKAAAAAAAAA
AAAAAAAAAAAAAAAAAAAAAAAAAAAAKKKKKKKKKKKKKAAAAAAAAA
AAAAAAAAAAAAAAAAAAAAAAAAAAAAAAAAAAAAAAAAAAAAAAAAAA
AAAAAAAAAAAAAAAAAAAAAAAAAAAAAAAAAAAAAAAAAAAAAAAAAA
AAAAAAAAAAAAAAAAAAAAAAAAAAAAAAAAAAAAAAAAAAAAAAAAAA
AAAAAAAAAAAAAAAAAAAAAAAAAAAAAAAAAAAAAAAAAAAAAAAAAA
AAAAAAAAAAAAAAAAAAAAAAAAAAAAAAAAAAAAAAAAAAAAAAAAAA
AAAAAAAAAAAAAAAAAAAAAAAAAAAAAAAAAAAAAAAAAAAAAAAAAA
AAAAAAAAAAAAAAAAAAAAAAAAAAAAAAAAAAAAAAAAAAAAAAAAAA
AAAAAAAAAAAAAAAAAAAAAAAAAAAAAAAAAAAAAAAAAAAAAAAAAA
AAAAAAAAAAAAAAAAAAAAAAAAAAAAAAAAAAAAAAAAAAAAAAAAAA
AAAAAAAAAAAAAAAAAAAAAAAAAAAAAAAAAAAAAAAAAAAAAAAAAA
AAAAAAAAAAAAAAAAAAAAAAAAAAAAAAAAAAAAAAAAAAAAAAAAAA
AAAAAAAAAAAAAAAAAAAAAAAAAAAAAAAAAAAAAAAAAAAAAAAAAA
AAAAAAAAAAAAAAAAAAAAAAAAAAAAAAAAAAAAAAAAAAAAAAAAAA
AAAAAAAAAAAAAAAAAAAAAAAAAAAAAAAAAAAAAAAAAAAAAAAAAA
AAAAAAAAAAAAAAAAAAAAAAAAAAAAAAAAAAAAAAAAAAAAAAAAAA
AAAAAAAAAAAAAAAAAAAAAAAAAAAAAAAAAAAAAAAAAAAAAAAAAA
AAAAAAAAAAAAAAAAAAAAAAAAAAAAAAAAAAAAAAAAAAAAAAAAAA
AAAAAAAAAAAAAAAAAAAAAAAAAAAAAAAAAAAAAAAAAAAAAAAAAA
AAAAAAAAAAAAAAAAAAAAAAAAAAAAAAAAAAAAAAAAAAAAAAAAAA
AAAAAAAAAAAAAAAAAAAAAAAAAAAAAAAAAAAAAAAAAAAAAAAAAA
AAAAAAAAAAAAAAAAAAAAAAAAAAAAAAAAAAAAAAAAAAAAAAAAAA
AAAAAAAAAAAAAAAAAAAAAAAAAAAAAAAAAAAAAAAAAAAAAAAAAA
AAAAAAAAAAAAAAAAAAAAAAAAAAAAAAAAAAAAAAAAAAAAAAAAAA
AAAAAAAAAAAAAAAAAAAAAAAAAAAAAAAAAAAAAAAAAAAAAAAAAA
AAAAAAAAAAAAAAAAAAAAAAAAAAAAAAAAAAAAAAAAAAAAAAAAAA
"}
