"aa" = (/obj/structure/ms13/craftable/scrap,/turf/open/floor/plating/ms13/ground/desert,/area/space)
"ah" = (/obj/machinery/door/unpowered/ms13/seethrough/metal,/obj/structure/ms13/rug/rubber,/turf/open/floor/ms13/tile/large/black,/area/space)
"aV" = (/obj/structure/bed/ms13/bedframe/wire,/obj/structure/bed/ms13/mattress/filthy,/turf/open/floor/wood/ms13/wide,/area/space)
"bs" = (/obj/structure/table/ms13/no_smooth/cable_reel,/turf/open/floor/plating/ms13/ground/sidewalk,/area/space)
"cw" = (/turf/closed/indestructible/rock/ms13,/area/space)
"dZ" = (/obj/machinery/door/unpowered/ms13/metal,/turf/open/floor/wood/ms13/wide,/area/space)
"gR" = (/obj/structure/ms13/storage/trashcan,/turf/open/floor/wood/ms13/wide,/area/space)
"ic" = (/turf/open/floor/wood/ms13/wide,/area/space)
"jq" = (/obj/structure/ms13/wall_decor/calendar,/obj/structure/table/ms13/no_smooth/counter/metal/bend{dir = 1},/turf/open/floor/wood/ms13/wide,/area/space)
"md" = (/obj/effect/turf_decal/ms13/covering/paint/gray,/turf/closed/wall/ms13/metal,/area/space)
"mw" = (/obj/structure/sink/ms13/functional{dir = 4},/turf/open/floor/wood/ms13/wide,/area/space)
"nZ" = (/obj/structure/dresser/ms13/orange/tall,/turf/open/floor/wood/ms13/wide,/area/space)
"ot" = (/obj/structure/table/ms13/no_smooth/counter/metal{dir = 8},/turf/open/floor/wood/ms13/wide,/area/space)
"oM" = (/obj/structure/chair/comfy/ms13/diner{dir = 4},/turf/open/floor/wood/ms13/wide,/area/space)
"su" = (/obj/machinery/light/ms13/bulb{dir = 1},/turf/open/floor/wood/ms13/wide,/area/space)
"tk" = (/turf/open/floor/plating/ms13/ground/sidewalk,/area/space)
"vh" = (/turf/closed/wall/ms13/concrete,/area/space)
"vT" = (/turf/closed/indestructible/rock/ms13,/area/start)
"zg" = (/turf/closed/wall/ms13/metal/reinforced,/area/space)
"CC" = (/obj/structure/closet/ms13/fridge,/obj/structure/ms13/storage/vent,/turf/open/floor/wood/ms13/wide,/area/space)
"Eh" = (/turf/open/floor/plating/ms13/ground/desertalt,/area/space)
"FF" = (/turf/open/floor/plating/ms13/ground/road,/area/space)
"Kq" = (/obj/structure/ms13/wall_decor/flag{icon_state = "flag_trans"},/turf/open/floor/wood/ms13/wide,/area/space)
"Op" = (/obj/structure/ms13/rug/red,/turf/open/floor/wood/ms13/wide,/area/space)
"Pk" = (/obj/structure/table/ms13/no_smooth/wood,/obj/structure/ms13/tv/tube/small{dir = 4; pixel_y = 9},/turf/open/floor/wood/ms13/wide,/area/space)
"PI" = (/turf/closed/indestructible/splashscreen,/area/start)
"PW" = (/turf/open/floor/ms13/concrete,/area/space)
"Qq" = (/obj/structure/chair/comfy/ms13/diner{dir = 8},/turf/open/floor/wood/ms13/wide,/area/space)
"QV" = (/obj/structure/table/ms13/wood/bar,/turf/open/floor/wood/ms13/wide,/area/space)
"SW" = (/obj/machinery/button/ms13{id = "mojavecom-transhouse-windows"},/turf/open/floor/wood/ms13/wide,/area/space)
"TR" = (/obj/structure/ms13/wall_decor/flag{desc = "A faded flag depicting vertical stripes. Depicting pride and power remaining in a once dead world."; icon_state = "flag_trans"},/obj/machinery/griddle/ms13,/turf/open/floor/wood/ms13/wide,/area/space)
"TS" = (/turf/closed/indestructible/riveted,/area/start)
"UA" = (/obj/structure/table/ms13/low_wall/metal,/obj/structure/window/fulltile/ms13/glass,/obj/machinery/door/poddoor/shutters/ms13/horizontal/indestructible/red/solo/pre_open{id = "mojavecom-transhouse-windows"},/turf/open/floor/wood/ms13/wide,/area/space)
"UC" = (/turf/closed/wall/ms13/metal,/area/space)
"Vj" = (/obj/effect/landmark/start/new_player,/turf/open/floor/plating,/area/start)
"VX" = (/obj/machinery/door/unpowered/ms13/seethrough/mirrored/metal,/turf/open/floor/ms13/tile/large/black,/area/space)
"Wi" = (/obj/structure/table/ms13/no_smooth/counter/metal{dir = 4},/obj/machinery/light/ms13/bulb{dir = 4},/turf/open/floor/wood/ms13/wide,/area/space)
"WC" = (/obj/machinery/light/ms13/bulb,/turf/open/floor/wood/ms13/wide,/area/space)
"XL" = (/obj/structure/table/ms13/low_wall/metal,/obj/structure/window/fulltile/ms13/glass,/obj/machinery/door/poddoor/shutters/ms13/vertical/indestructible/red/mid/pre_open{id = "mojavecom-transhouse-windows"},/turf/open/floor/wood/ms13/wide,/area/space)
"ZW" = (/turf/open/floor/plating/ms13/ground/desert,/area/space)

(1,1,1) = {"
cwcwcwcwcwcwcwcwcwcwcwcwcwcwcwcwcwcwcwcwcwcwcwcwcwcwcwcwcwcwcwcwcwcwcwcwcwcwcwcwcwcwcwcwcwcwcwcwcwcwcwcwcwcwcwcwcwcwcwcwcwcwcwcwcwcwcwcwcwcwcwcwcwcwcwcwcwcwcwcwcwcwcwcwcwcwcwcwcwcwcwcwcwcwcw
cwcwcwZWZWZWZWZWZWZWZWcwcwcwcwcwcwcwcwcwcwcwcwcwcwcwcwZWZWZWZWZWZWZWZWcwcwcwcwcwcwcwcwcwcwcwcwcwcwcwcwcwcwcwcwcwcwcwcwcwcwcwcwcwcwcwcwcwcwZWZWZWcwcwcwcwcwcwcwcwcwcwcwcwcwcwcwcwcwcwcwcwcwcwcw
cwZWZWZWZWZWZWZWZWZWZWZWZWZWZWZWZWZWZWZWZWZWZWZWZWZWZWZWZWZWZWZWZWZWZWZWZWZWZWZWZWZWZWZWZWZWZWZWZWZWZWZWZWZWZWZWZWZWZWZWZWZWZWZWZWZWZWZWZWZWZWZWZWZWZWZWZWZWZWZWZWZWZWZWZWZWZWZWZWZWZWZWcwcwcw
cwZWZWZWZWZWZWZWZWZWZWZWZWZWZWZWZWZWZWZWZWZWZWZWZWZWZWZWZWZWZWZWZWZWZWZWZWZWZWZWZWZWZWZWZWZWZWZWZWZWZWZWZWZWZWZWZWZWZWZWZWZWZWZWZWZWZWZWZWZWZWZWZWZWZWZWZWZWZWZWZWZWZWZWZWZWZWZWZWZWZWZWZWcwcw
cwZWZWZWZWZWZWZWZWZWZWZWZWZWZWZWZWZWZWZWZWZWZWZWZWZWZWZWZWZWZWZWZWZWZWZWZWZWZWZWZWZWZWZWZWZWZWZWZWZWZWZWZWZWZWZWZWZWZWZWZWZWZWZWZWZWZWZWZWZWZWZWZWZWZWZWZWZWZWZWZWZWZWZWZWZWZWZWZWZWZWZWZWcwcw
cwcwZWZWZWZWZWvhvhvhvhvhvhvhvhvhvhvhvhvhvhvhvhvhvhvhvhvhvhvhvhvhvhvhvhvhvhvhvhvhvhvhvhvhvhvhvhvhaaaaaavhvhvhvhvhvhvhvhvhvhvhvhvhvhvhvhvhvhvhvhvhvhvhZWZWZWZWZWZWZWZWZWZWZWZWZWZWZWZWZWZWZWcwcw
cwcwZWZWZWZWZWvhvhvhvhvhvhvhvhvhvhvhvhvhvhvhvhvhvhvhvhvhvhvhvhvhvhvhvhvhvhvhvhvhvhvhvhvhvhvhvhvhvhaaaavhvhvhvhvhvhvhvhvhvhvhvhvhvhvhvhvhvhvhvhvhvhvhZWZWZWZWZWZWZWZWZWZWZWZWZWZWZWZWZWZWZWcwcw
cwcwZWZWZWZWZWvhvhvhvhvhvhvhvhvhvhvhvhvhvhvhvhvhvhvhvhvhvhvhvhvhvhvhvhvhvhvhvhvhvhvhvhvhvhvhvhvhvhaaaaaavhvhvhvhvhvhvhvhvhvhvhvhvhvhvhvhvhvhvhvhvhvhZWZWZWZWZWZWZWZWZWZWZWZWZWZWZWZWZWZWZWZWcw
cwcwZWZWZWZWZWvhvhvhZWZWZWZWZWZWZWZWZWZWZWZWZWZWZWZWZWZWZWZWZWZWZWZWZWZWZWZWZWZWZWZWZWZWZWZWZWZWZWZWZWZWZWZWZWZWZWZWZWZWZWZWZWZWZWZWZWZWZWZWZWvhvhvhZWZWZWZWZWZWZWZWZWZWZWZWZWZWZWZWZWZWZWZWcw
cwcwZWZWZWZWZWvhvhvhZWZWZWZWZWZWZWZWZWZWZWZWZWZWZWZWZWZWZWZWZWZWZWZWZWZWZWZWZWZWZWZWZWZWZWZWZWZWZWZWZWZWZWZWZWZWZWZWZWZWZWZWZWZWZWZWZWZWZWZWZWvhvhvhZWZWZWZWZWZWZWZWZWZWZWZWZWZWZWZWZWZWZWZWcw
cwcwZWZWZWZWZWvhvhvhZWZWZWZWZWZWZWZWZWZWZWZWZWZWZWZWZWZWZWZWZWZWZWZWZWZWZWZWZWZWZWZWZWZWZWZWZWZWZWZWZWZWZWZWZWZWZWZWZWZWZWZWZWZWZWZWZWZWZWZWZWvhvhvhZWZWZWZWZWZWZWZWZWZWZWZWZWZWZWZWZWZWZWZWcw
cwZWZWZWZWZWZWvhvhvhZWZWZWZWFFFFFFFFFFFFFFFFFFFFFFFFFFFFFFFFFFFFFFFFFFFFFFFFFFFFFFFFFFFFFFFFFFFFFFFFFFFFFFFFFFFFFFFFFFFFZWUCUCUCUCUCUCUCUCZWZWvhvhvhZWZWZWZWZWZWZWZWZWZWZWZWZWZWZWZWZWZWZWZWcw
cwZWZWZWZWZWZWvhvhvhZWZWZWZWFFFFFFFFFFFFFFFFFFFFFFFFFFFFFFFFFFFFFFFFFFFFFFFFFFFFFFFFFFFFFFFFFFFFFFFFFFFFFFFFFFFFFFFFFFFFZWUCPWPWPWPWPWPWUCZWZWvhvhvhZWZWZWZWZWZWZWZWZWZWZWZWZWZWZWZWZWZWZWZWcw
cwZWZWZWZWZWZWvhvhvhZWZWZWZWFFFFFFFFFFFFFFFFFFFFFFFFFFFFFFFFFFFFFFFFFFFFFFFFFFFFFFFFFFFFFFFFFFFFFFFFFFFFFFFFFFFFFFFFFFFFZWUCPWPWPWPWPWPWUCZWZWvhvhvhZWZWZWZWZWZWZWZWZWZWZWZWZWZWZWZWZWZWZWZWcw
cwZWZWZWZWZWZWaavhvhZWZWZWZWFFFFFFZWZWZWZWZWZWZWZWZWZWZWZWZWZWZWZWZWZWZWZWZWZWZWZWZWZWZWZWZWZWZWZWZWZWZWZWZWZWZWZWFFFFFFZWUCPWPWPWPWPWPWUCZWZWvhvhvhZWZWZWZWZWZWZWZWZWZWZWZWZWZWZWZWZWZWZWZWcw
cwcwZWZWZWZWZWaavhvhZWZWZWZWFFFFFFZWUCUCUCUCUCUCUCUCUCUCUCUCUCUCUCUCZWZWZWZWZWZWUCUCUCUCUCUCUCUCUCUCUCUCUCUCUCUCZWFFFFFFZWUCPWPWPWPWPWPWUCZWZWvhvhvhZWZWZWZWZWZWZWZWZWZWZWZWZWZWZWZWZWZWZWZWcw
cwcwZWZWZWZWZWaaaavhZWZWZWZWFFFFFFZWUCPWPWPWPWPWPWPWPWPWPWPWPWPWPWUCZWZWZWZWZWZWUCPWPWPWPWPWPWPWPWPWPWPWPWPWPWUCZWFFFFFFZWUCPWPWPWPWPWPWUCZWZWvhvhvhZWZWZWZWZWZWZWZWZWZWZWZWZWZWZWZWZWZWZWZWcw
cwcwZWZWZWZWZWaaaaaaZWZWZWZWFFFFFFZWUCPWPWPWPWPWPWPWPWPWPWPWPWPWPWUCZWZWZWZWZWZWUCPWPWPWPWPWPWPWPWPWPWPWPWPWPWUCZWFFFFFFZWUCPWPWPWPWPWPWUCZWZWvhvhvhZWZWZWZWZWZWZWZWZWZWZWZWZWZWZWZWZWZWZWcwcw
cwcwZWZWZWZWZWaaaaaaZWZWZWZWFFFFFFZWUCPWPWPWPWPWPWPWPWPWPWPWPWPWPWUCZWZWZWZWZWZWUCPWPWPWPWPWPWPWPWPWPWPWPWPWPWUCZWFFFFFFZWUCPWPWPWPWPWPWUCZWZWvhvhvhZWZWZWZWZWZWZWZWZWZWZWZWZWZWZWZWZWZWZWcwcw
cwcwcwZWZWZWZWaaaaaaZWZWZWZWFFFFFFZWUCPWPWPWPWPWPWPWPWPWPWPWPWPWPWUCZWZWZWZWZWZWUCPWPWPWPWPWPWPWPWPWPWPWPWPWPWUCZWFFFFFFZWUCPWPWPWPWPWPWUCZWZWvhvhvhZWZWZWZWZWZWZWZWZWZWZWZWZWZWZWZWZWZWZWcwcw
cwcwZWZWZWZWZWaaaaaaZWZWZWZWFFFFFFZWUCPWPWPWPWUCUCUCUCUCUCUCUCUCUCUCZWZWZWZWZWZWUCUCUCUCUCPWPWPWPWPWPWPWPWPWPWUCZWFFFFFFZWUCPWPWPWPWPWPWUCZWZWvhvhvhZWZWZWZWZWZWZWZWZWZWZWZWZWZWZWZWZWZWZWcwcw
cwcwZWZWZWZWZWvhaaaaZWZWZWZWFFFFFFZWUCPWPWPWPWUCZWZWZWZWZWZWZWZWZWZWZWZWZWZWZWZWZWZWZWZWUCPWPWPWPWPWPWPWPWPWPWUCZWFFFFFFZWUCPWPWPWPWPWPWUCZWZWvhvhvhZWZWZWZWZWZWZWZWZWZWZWZWZWZWZWZWZWZWZWcwcw
cwcwZWZWZWZWZWvhaaaaZWZWZWZWFFFFFFZWUCPWPWPWPWUCZWZWZWZWZWZWZWZWZWZWZWZWZWZWZWZWZWZWZWZWUCPWPWPWPWPWPWPWPWPWPWUCZWFFFFFFZWUCPWPWPWPWPWPWUCZWZWvhvhvhZWZWZWZWZWZWZWZWZWZWZWZWZWZWZWZWZWZWZWcwcw
cwZWZWZWZWZWZWvhvhvhZWZWZWZWFFFFFFZWUCPWPWPWPWUCZWZWZWZWZWZWZWZWZWZWZWZWZWZWZWZWZWZWZWZWUCUCUCUCUCUCUCUCUCUCUCUCZWFFFFFFZWUCPWPWPWPWPWPWUCZWZWvhvhvhZWZWZWZWZWZWZWZWZWZWZWZWZWZWZWZWZWZWZWcwcw
cwZWZWZWZWZWZWvhvhvhZWZWZWZWFFFFFFZWUCUCUCUCUCUCZWZWZWZWZWZWZWZWZWZWZWZWZWZWZWZWZWZWZWZWZWZWZWZWZWZWZWZWZWZWZWZWZWFFFFFFZWUCUCUCUCUCUCUCUCZWZWvhvhvhZWZWZWZWZWZWZWZWZWZWZWZWZWZWZWZWZWZWZWcwcw
cwZWZWZWZWZWZWvhvhvhZWZWZWZWFFFFFFZWZWZWZWZWZWZWZWZWZWZWZWZWZWZWZWZWZWZWZWZWZWZWZWZWZWZWZWZWZWZWZWZWZWZWZWZWZWZWZWFFFFFFZWZWZWZWZWZWZWZWZWZWZWvhvhvhZWZWZWZWZWZWZWZWZWZWZWZWZWZWZWZWZWZWZWcwcw
cwZWZWZWZWZWZWvhvhvhZWZWZWZWFFFFFFZWUCmdmdmdUCmdmdmdUCZWZWUCUCUCUCUCUCUCUCUCUCUCUCUCZWZWZWUCUCUCUCUCUCUCUCUCUCUCZWFFFFFFZWUCUCUCUCUCUCUCUCUCZWvhvhvhZWZWZWZWZWZWZWZWZWZWZWZWZWZWZWZWZWZWZWcwcw
cwcwZWZWZWZWZWvhvhvhZWZWZWZWFFFFFFZWmdCCTRjqUCPksunZUCZWZWUCPWPWPWPWPWPWPWPWPWPWPWUCZWZWZWUCPWPWPWPWPWPWPWPWPWUCZWFFFFFFZWUCPWPWPWPWPWPWPWUCZWvhvhvhZWZWZWZWZWZWZWZWZWZWZWZWZWZWZWZWZWZWZWZWcw
cwcwZWZWZWZWZWvhvhvhZWZWZWZWFFFFFFZWXLicicWiUCicOpaVUCZWZWUCPWPWPWPWPWPWPWPWPWPWPWUCZWZWZWUCPWPWPWPWPWPWPWPWPWUCZWFFFFFFZWUCPWPWPWPWPWPWPWUCZWvhvhvhZWZWZWZWZWZWZWZWZWZWZWZWZWZWZWZWZWZWZWZWcw
cwcwZWZWZWZWZWvhvhvhZWZWZWZWFFFFFFZWmdmwicotmddZmdmdUCZWZWUCPWPWPWPWPWPWPWPWPWPWPWUCZWZWZWUCPWPWPWPWPWPWPWPWPWUCZWFFFFFFZWUCPWPWPWPWPWPWPWUCZWvhvhvhZWZWZWZWZWZWZWZWZWZWZWZWZWZWZWZWZWZWZWZWcw
cwcwZWZWZWZWZWvhvhvhZWZWZWZWFFFFFFZWXLicicicSWicKqgRUCZWZWUCPWPWPWPWPWPWPWPWPWPWPWUCZWZWZWUCPWPWPWPWPWPWPWPWPWUCZWFFFFFFZWUCPWPWPWPWPWPWPWUCZWvhvhvhZWZWZWZWZWZWZWZWZWZWZWZWZWZWZWZWZWZWZWZWcw
cwcwZWZWZWZWZWzgvhzgZWZWZWZWFFFFFFZWUCoMQVQqWCicicicUCZWZWUCPWPWPWPWPWPWPWPWPWPWPWUCZWZWZWUCPWPWPWPWPWPWPWPWPWUCZWFFFFFFZWUCPWPWPWPWPWPWPWUCZWzgvhzgZWZWZWZWZWZWZWZWZWZWZWZWZWZWZWZWZWZWZWZWcw
cwZWZWZWZWZWZWzgzgzgZWZWZWZWFFFFFFZWUCUCUAUCUCahVXUCUCZWZWUCUCUCUCUCUCUCUCUCUCUCUCUCZWZWZWUCUCUCUCUCUCUCUCUCUCUCZWFFFFFFZWUCUCUCUCUCUCUCUCUCZWzgzgzgZWZWZWZWZWZWZWZWZWZWZWZWZWZWZWZWZWZWZWZWcw
cwZWZWZWZWZWZWZWZWZWZWZWZWZWFFFFFFZWZWZWZWZWbstktktkZWZWZWZWZWZWZWZWZWZWZWZWZWZWZWZWZWZWZWZWZWZWZWZWZWZWZWZWZWZWZWFFFFFFZWZWZWZWZWZWZWZWZWZWZWZWZWZWZWZWZWZWZWZWZWZWZWZWZWZWZWZWZWZWZWZWZWZWcw
cwFFFFFFFFFFFFFFFFFFFFFFFFFFFFFFFFFFFFFFFFFFFFFFFFFFFFFFFFFFFFFFFFFFFFFFFFFFFFFFFFFFFFFFFFFFFFFFFFFFFFFFFFFFFFFFFFFFFFFFFFFFFFFFFFFFFFFFFFFFFFFFFFFFFFFFFFFFFFFFFFFFFFFFFFFFFFFFFFFFFFFFFFFFcw
cwFFFFFFFFFFFFFFFFFFFFFFFFFFFFFFFFFFFFFFFFFFFFFFFFFFFFFFFFFFFFFFFFFFFFFFFFFFFFFFFFFFFFFFFFFFFFFFFFFFFFFFFFFFFFFFFFFFFFFFFFFFFFFFFFFFFFFFFFFFFFFFFFFFFFFFFFFFFFFFFFFFFFFFFFFFFFFFFFFFFFFFFFFFcw
cwFFFFFFFFFFFFFFFFFFFFFFFFFFFFFFFFFFFFFFFFFFFFFFFFFFFFFFFFFFFFFFFFFFFFFFFFFFFFFFFFFFFFFFFFFFFFFFFFFFFFFFFFFFFFFFFFFFFFFFFFFFFFFFFFFFFFFFFFFFFFFFFFFFFFFFFFFFFFFFFFFFFFFFFFFFFFFFFFFFFFFFFFFFcw
cwcwZWZWZWZWZWZWZWZWZWZWZWZWFFFFFFZWZWZWZWZWZWZWZWZWZWZWZWZWZWZWZWZWZWZWZWEhZWZWZWZWZWZWZWZWZWZWZWZWZWZWZWZWZWZWZWZWZWZWZWZWZWZWFFFFFFZWZWZWZWZWZWZWZWZWZWZWZWZWZWZWZWZWZWZWZWZWZWZWZWZWZWZWcw
cwcwZWZWZWZWZWzgzgzgZWZWZWZWFFFFFFZWUCUCUCUCUCUCUCUCZWUCUCUCUCUCUCUCUCUCUCEhUCUCUCUCUCUCUCUCUCUCUCUCZWUCUCUCUCUCUCUCUCUCUCUCUCZWFFFFFFZWZWZWZWzgzgzgZWZWZWZWZWZWZWZWZWZWZWZWZWZWZWZWZWZWZWZWcw
cwZWZWZWZWZWZWzgvhzgZWZWZWZWFFFFFFZWUCPWPWPWPWPWPWUCZWUCPWPWPWPWPWPWPWPWUCEhUCPWPWPWPWPWPWPWPWPWPWUCZWUCPWPWPWPWPWPWPWPWPWPWUCZWFFFFFFZWZWZWZWzgvhzgZWZWZWZWZWZWZWZWZWZWZWZWZWZWZWZWZWZWZWZWcw
cwZWZWZWZWZWZWvhvhvhZWZWZWZWFFFFFFZWUCPWPWPWPWPWPWUCZWUCPWPWPWPWPWPWPWPWUCEhUCPWPWPWPWPWPWPWPWPWPWUCZWUCPWPWPWPWPWPWPWPWPWPWUCZWFFFFFFZWZWZWZWvhvhvhZWZWZWZWZWZWZWZWZWZWZWZWZWZWZWZWZWZWZWZWcw
cwZWZWZWZWZWZWvhvhvhZWZWZWZWFFFFFFZWUCPWPWPWPWPWPWUCZWUCPWPWPWPWPWPWPWPWUCEhUCPWPWPWPWPWPWPWPWPWPWUCZWUCPWPWPWPWPWPWPWPWPWPWUCZWFFFFFFZWZWZWZWvhvhvhZWZWZWZWZWZWZWZWZWZWZWZWZWZWZWZWZWZWZWZWcw
cwcwZWZWZWZWZWvhvhvhZWZWZWZWFFFFFFZWUCPWPWPWPWPWPWUCZWUCPWPWPWPWPWPWPWPWUCEhUCPWPWPWPWPWPWPWPWPWPWUCZWUCPWPWPWPWPWPWPWPWPWPWUCZWFFFFFFZWZWZWZWvhvhvhZWZWZWZWZWZWZWZWZWZWZWZWZWZWZWZWZWZWZWZWcw
cwcwZWZWZWZWZWvhvhvhZWZWZWZWFFFFFFZWUCPWPWPWPWPWPWUCZWUCPWPWPWPWPWPWPWPWUCEhUCUCUCUCUCUCPWPWPWPWPWUCZWUCPWPWPWPWPWPWPWPWPWPWUCZWFFFFFFZWZWZWZWvhvhvhZWZWZWZWZWZWZWZWZWZWZWZWZWZWZWZWZWZWZWcwcw
cwcwZWZWZWZWZWvhvhvhZWZWZWZWFFFFFFZWUCPWPWPWPWPWPWUCZWUCUCUCUCUCUCUCUCUCUCEhEhZWZWZWZWUCPWPWPWPWPWUCZWUCPWPWPWPWPWPWPWPWPWPWUCZWFFFFFFZWZWZWZWvhvhvhZWZWZWZWZWZWZWZWZWZWZWZWZWZWZWZWZWZWZWcwcw
cwZWZWZWZWZWZWvhvhvhZWZWZWZWFFFFFFZWUCPWPWPWPWPWPWUCZWZWZWZWZWZWZWZWZWZWZWEhEhZWZWZWZWUCPWPWPWPWPWUCZWUCUCUCUCUCUCUCUCUCUCUCUCZWFFFFFFZWZWZWZWvhvhvhZWZWZWZWZWZWZWZWZWZWZWZWZWZWZWZWZWZWZWcwcw
cwZWZWZWZWZWZWvhvhvhZWZWZWZWFFFFFFZWUCPWPWPWPWPWPWUCZWZWZWZWZWZWZWZWZWEhEhEhEhEhZWZWZWUCPWPWPWPWPWUCZWZWZWZWZWEhEhEhEhEhEhEhEhEhFFFFFFZWZWZWZWvhvhvhZWZWZWZWZWZWZWZWZWZWZWZWZWZWZWZWZWZWZWcwcw
cwcwZWZWZWZWZWvhvhvhZWZWZWZWFFFFFFZWUCPWPWPWPWPWPWUCZWZWZWZWZWZWZWEhEhEhEhEhEhEhEhEhZWUCPWPWPWPWPWUCZWZWEhEhEhEhEhEhEhEhEhEhEhEhFFFFFFZWZWZWZWvhvhvhZWZWZWZWZWZWZWZWZWZWZWZWZWZWZWZWZWZWZWcwcw
cwcwZWZWZWZWZWvhvhvhZWZWZWZWFFFFFFZWUCUCUCUCUCUCUCUCZWZWZWZWZWZWEhEhEhZWZWZWEhEhEhEhZWUCPWPWPWPWPWUCZWEhEhEhUCUCUCUCUCUCUCUCUCZWFFFFFFZWZWZWZWvhvhvhZWZWZWZWZWZWZWZWZWZWZWZWZWZWZWZWZWZWZWcwcw
cwcwZWZWZWZWZWvhvhvhZWZWZWZWFFFFFFZWZWZWZWZWZWZWZWZWZWZWZWEhEhEhEhZWZWZWZWZWZWEhEhEhEhUCUCUCUCUCUCUCZWEhEhZWUCPWPWPWPWPWPWPWUCZWFFFFFFZWZWZWZWvhvhvhZWZWZWZWZWZWZWZWZWZWZWZWZWZWZWZWZWZWZWcwcw
cwcwZWZWZWZWZWvhvhvhZWZWZWZWFFFFFFZWUCUCUCUCUCUCUCUCZWEhEhEhZWZWZWZWZWZWZWZWZWZWEhEhEhEhEhEhEhEhEhEhEhEhZWZWUCPWPWPWPWPWPWPWUCZWFFFFFFZWZWZWZWvhvhaaZWZWZWZWZWZWZWZWZWZWZWZWZWZWZWZWZWZWZWcwcw
cwcwZWZWZWZWZWvhvhvhZWZWZWZWFFFFFFZWUCPWPWPWPWPWPWUCZWEhEhUCUCUCUCUCUCUCUCUCUCUCUCUCUCUCUCUCUCUCEhEhEhEhZWZWUCPWPWPWPWPWPWPWUCZWFFFFFFZWZWZWZWvhaaaaZWZWZWZWZWZWZWZWZWZWZWZWZWZWZWZWZWZWZWcwcw
cwcwZWZWZWZWZWvhvhvhZWZWZWZWFFFFFFZWUCPWPWPWPWPWPWUCZWEhEhUCPWPWPWPWPWPWPWPWPWPWPWPWPWPWPWPWPWUCZWZWEhEhZWZWUCPWPWPWPWPWPWPWUCZWFFFFFFZWZWZWZWaaaaaaZWZWZWZWZWZWZWZWZWZWZWZWZWZWZWZWZWZWZWZWcw
cwZWZWZWZWZWZWvhvhvhZWZWZWZWFFFFFFZWUCPWPWPWPWPWPWUCZWEhEhUCPWPWPWPWPWPWPWPWPWPWPWPWPWPWPWPWPWUCZWZWZWEhEhZWUCPWPWPWPWPWPWPWUCZWFFFFFFZWZWZWZWaaaaaaZWZWZWZWZWZWZWZWZWZWZWZWZWZWZWZWZWZWZWZWcw
cwZWZWZWZWZWZWvhvhvhZWZWZWZWFFFFFFZWUCPWPWPWPWPWPWUCZWEhEhUCPWPWPWPWPWPWPWPWPWPWPWPWPWPWPWPWPWUCZWZWZWZWEhEhUCUCUCUCUCUCUCUCUCEhFFFFFFZWZWZWZWaaaaaaZWZWZWZWZWZWZWZWZWZWZWZWZWZWZWZWZWZWZWZWcw
cwZWZWZWZWZWZWvhvhvhZWZWZWZWFFFFFFZWUCPWPWPWPWPWPWUCZWEhEhUCPWPWPWPWPWPWPWPWPWPWPWPWPWPWPWPWPWUCZWZWZWZWEhEhEhEhEhEhEhEhEhEhEhEhFFFFFFZWZWZWZWvhaaaaZWZWZWZWZWZWZWZWZWZWZWZWZWZWZWZWZWZWZWZWcw
cwcwZWZWZWZWZWvhvhvhZWZWZWZWFFFFFFZWUCPWPWPWPWPWPWUCZWEhEhUCPWPWPWPWPWPWPWPWPWPWPWPWPWPWPWPWPWUCZWZWZWZWZWUCUCUCUCUCUCUCUCUCUCEhFFFFFFZWZWZWZWvhaaaaZWZWZWZWZWZWZWZWZWZWZWZWZWZWZWZWZWZWZWZWcw
cwcwcwZWZWZWZWvhvhvhZWZWZWZWFFFFFFZWUCPWPWPWPWPWPWUCZWEhEhUCPWPWPWPWPWPWPWPWPWPWPWPWPWPWPWPWPWUCZWZWZWZWZWUCPWPWPWPWPWPWPWPWUCZWFFFFFFZWZWZWZWvhvhaaZWZWZWZWZWZWZWZWZWZWZWZWZWZWZWZWZWZWZWZWcw
cwcwZWZWZWZWZWvhvhvhZWZWZWZWFFFFFFZWUCPWPWPWPWPWPWUCZWEhEhUCPWPWPWPWPWPWPWPWPWPWPWPWPWPWPWPWPWUCZWZWZWZWZWUCPWPWPWPWPWPWPWPWUCZWFFFFFFZWZWZWZWvhvhaaZWZWZWZWZWZWZWZWZWZWZWZWZWZWZWZWZWZWZWZWcw
cwcwZWZWZWZWZWvhvhvhZWZWZWZWFFFFFFZWUCUCUCUCUCUCUCUCZWEhEhUCUCUCUCUCUCUCUCUCUCUCUCUCUCPWPWPWPWUCZWZWZWZWZWUCPWPWPWPWPWPWPWPWUCZWFFFFFFZWZWZWZWvhvhvhZWZWZWZWZWZWZWZWZWZWZWZWZWZWZWZWZWZWZWcwcw
cwZWZWZWZWZWZWvhvhvhZWZWZWZWFFFFFFZWZWZWZWZWZWZWZWZWZWEhZWZWZWZWZWZWZWZWZWZWZWZWZWZWUCPWPWPWPWUCZWZWZWZWZWUCPWPWPWPWPWPWPWPWUCZWFFFFFFZWZWZWZWvhvhvhZWZWZWZWZWZWZWZWZWZWZWZWZWZWZWZWZWZWZWcwcw
cwZWZWZWZWZWZWvhvhvhZWZWZWZWFFFFFFFFFFFFFFFFFFFFFFFFFFFFFFFFFFFFFFFFFFFFFFFFFFFFFFZWUCPWPWPWPWUCZWZWZWZWZWUCPWPWPWPWPWPWPWPWUCZWFFFFFFZWZWZWZWvhvhvhZWZWZWZWZWZWZWZWZWZWZWZWZWZWZWZWZWZWZWcwcw
cwZWZWZWZWZWZWvhvhvhZWZWZWZWFFFFFFFFFFFFFFFFFFFFFFFFFFFFFFFFFFFFFFFFFFFFFFFFFFFFFFZWUCPWPWPWPWUCZWZWZWZWZWUCPWPWPWPWPWPWPWPWUCZWFFFFFFZWZWZWZWvhvhvhZWZWZWZWZWZWZWZWZWZWZWZWZWZWZWZWZWZWZWZWcw
cwcwZWZWZWZWZWvhvhvhZWZWZWZWFFFFFFFFFFFFFFFFFFFFFFFFFFFFFFFFFFFFFFFFFFFFFFFFFFFFFFZWUCPWPWPWPWUCZWZWZWZWZWUCPWPWPWPWPWPWPWPWUCZWFFFFFFZWZWZWZWvhvhvhZWZWZWZWZWZWZWZWZWZWZWZWZWZWZWZWZWZWZWZWcw
cwZWZWZWZWZWZWvhvhvhZWZWZWZWZWZWZWZWZWZWZWZWZWZWZWZWZWZWZWZWZWZWZWZWZWZWZWZWFFFFFFZWUCPWPWPWPWUCZWZWZWZWZWUCPWPWPWPWPWPWPWPWUCZWFFFFFFZWZWZWZWvhvhvhZWZWZWZWZWZWZWZWZWZWZWZWZWZWZWZWZWZWZWZWcw
cwZWZWZWZWZWZWvhvhvhZWZWZWZWZWZWZWZWZWZWZWZWZWZWZWZWZWZWZWZWZWZWUCUCUCUCUCZWFFFFFFZWUCPWPWPWPWUCZWZWZWZWZWUCPWPWPWPWPWPWPWPWUCZWFFFFFFZWZWZWZWvhvhvhZWZWZWZWZWZWZWZWZWZWZWZWZWZWZWZWZWZWZWZWcw
cwZWZWZWZWZWZWvhvhvhvhvhvhvhvhvhvhvhvhvhvhvhvhvhvhvhaaaavhvhvhZWUCPWPWPWUCZWFFFFFFZWUCPWPWPWPWUCZWZWZWZWZWUCPWPWPWPWPWPWPWPWUCZWFFFFFFZWZWZWZWvhvhvhZWZWZWZWZWZWZWZWZWZWZWZWZWZWZWZWZWZWZWZWcw
cwZWZWZWZWZWZWvhvhvhvhvhvhvhvhvhvhvhvhvhvhvhvhvhvhvhaaaaaavhvhZWUCPWPWPWUCZWFFFFFFZWUCPWPWPWPWUCZWZWZWZWZWUCPWPWPWPWPWPWPWPWUCZWFFFFFFZWZWZWZWvhvhvhZWZWZWZWZWZWZWZWZWZWZWZWZWZWZWZWZWZWZWZWcw
cwcwZWZWZWZWZWvhvhvhvhvhvhvhvhvhvhvhvhvhvhvhvhvhvhaaaaaaaaaavhZWUCPWPWPWUCZWFFFFFFZWUCUCUCUCUCUCZWZWZWZWZWUCPWPWPWPWPWPWPWPWUCZWFFFFFFZWZWZWZWvhvhvhZWZWZWZWZWZWZWZWZWZWZWZWZWZWZWZWZWZWZWcwcw
cwcwZWZWZWZWZWZWZWZWZWZWZWZWZWZWZWZWZWZWZWZWZWZWZWZWZWZWaaaaaaZWUCPWPWPWUCZWFFFFFFZWZWZWZWZWZWZWZWZWZWZWZWUCPWPWPWPWPWPWPWPWUCZWFFFFFFZWZWZWZWvhvhvhZWZWZWZWZWZWZWZWZWZWZWZWZWZWZWZWZWZWZWcwcw
cwcwZWZWZWZWZWZWZWZWZWZWZWZWZWZWZWZWZWZWZWZWZWZWZWZWZWZWaaaaaaZWUCPWPWPWUCZWFFFFFFZWZWZWZWZWZWZWZWZWZWZWZWUCPWPWPWPWPWPWPWPWUCZWFFFFFFZWZWZWZWvhvhvhZWZWZWZWZWZWZWZWZWZWZWZWZWZWZWZWZWZWZWcwcw
cwcwZWZWZWZWZWZWZWZWZWZWZWZWZWZWZWZWZWZWZWZWZWZWZWZWZWZWaaaavhZWUCPWPWPWUCZWFFFFFFZWZWZWZWZWZWZWZWZWZWZWZWUCPWPWPWPWPWPWPWPWUCZWFFFFFFZWZWZWZWvhvhvhZWZWZWZWZWZWZWZWZWZWZWZWZWZWZWZWZWZWcwcwcw
cwcwcwcwcwcwcwZWZWZWZWZWZWZWZWZWZWZWZWZWZWZWZWZWZWZWZWZWvhaavhZWUCUCUCUCUCZWFFFFFFZWZWZWZWZWZWZWZWZWZWZWZWUCUCUCUCUCUCUCUCUCUCZWFFFFFFZWZWZWZWvhvhvhZWZWZWZWZWZWZWZWZWZWZWZWZWZWZWZWZWZWcwcwcw
cwcwcwcwcwcwcwcwZWcwZWZWZWZWZWZWZWZWZWZWZWZWZWZWZWZWZWZWvhvhvhZWZWZWZWZWZWZWFFFFFFZWZWZWZWZWZWZWZWZWZWZWZWZWZWZWZWZWZWZWZWZWZWZWFFFFFFZWZWZWZWvhvhvhZWZWZWZWZWZWZWZWZWZWZWZWZWZWZWZWZWZWZWcwcw
cwcwcwcwcwcwcwcwcwcwcwcwcwcwZWZWZWZWZWZWZWZWZWZWZWZWZWZWvhvhvhZWZWZWZWZWZWZWFFFFFFFFFFFFFFFFFFFFFFFFFFFFFFFFFFFFFFFFFFFFFFFFFFFFFFFFFFZWZWZWZWvhvhvhZWZWZWZWZWZWZWZWZWZWZWZWZWZWZWZWZWZWZWcwcw
cwcwcwcwcwcwcwcwcwcwcwcwcwcwcwcwcwcwZWZWZWZWZWZWZWZWZWZWvhvhvhZWUCUCUCUCUCZWFFFFFFFFFFFFFFFFFFFFFFFFFFFFFFFFFFFFFFFFFFFFFFFFFFFFFFFFFFZWZWZWZWvhvhvhZWZWZWZWZWZWZWZWZWZWZWZWZWZWZWZWZWZWZWcwcw
cwcwcwcwcwcwcwcwcwcwcwcwcwcwcwcwcwcwcwcwcwZWZWZWZWZWZWZWvhvhvhZWUCPWPWPWUCZWFFFFFFFFFFFFFFFFFFFFFFFFFFFFFFFFFFFFFFFFFFFFFFFFFFFFFFFFFFZWZWZWZWvhvhvhZWZWZWZWZWZWZWZWZWZWZWZWZWZWZWZWZWZWZWZWcw
cwcwcwcwcwcwcwcwcwcwcwcwcwcwcwcwcwcwcwcwcwcwZWZWZWZWZWZWvhvhvhZWUCPWPWPWUCZWZWZWZWZWZWZWZWZWZWZWZWZWZWZWZWZWZWZWZWZWZWZWZWZWZWZWZWZWZWZWZWZWZWvhvhvhZWZWZWZWZWZWZWZWZWZWZWZWZWZWZWZWZWZWZWZWcw
cwcwcwcwcwcwcwcwcwcwcwcwcwcwcwcwcwcwcwcwcwcwcwZWZWZWZWZWvhvhvhZWUCPWPWPWUCUCUCUCUCUCUCUCUCUCUCUCUCUCZWUCUCUCUCUCUCUCZWUCUCUCUCUCUCUCUCUCUCZWZWvhvhvhZWZWZWZWZWZWZWZWZWZWZWZWZWZWZWZWZWZWZWZWcw
vTvTvTvTvTvTvTvTvTvTvTvTvTvTvTvTvTvTvTvTvTcwcwcwZWZWZWZWvhvhvhZWUCPWPWPWPWPWUCPWPWPWPWPWPWPWPWPWPWUCZWUCPWPWPWPWPWUCZWUCPWPWPWPWPWPWPWPWUCZWZWvhvhvhZWZWZWZWZWZWZWZWZWZWZWZWZWZWZWZWZWZWZWZWcw
TSTSTSTSTSTSTSTSTSTSTSTSTSTSTSTSTSTSTSvTvTcwcwcwZWZWZWZWvhvhvhZWUCPWPWPWPWPWUCPWPWPWPWPWPWPWPWPWPWUCZWUCPWPWPWPWPWUCZWUCPWPWPWPWPWPWPWPWUCZWZWvhvhvhZWZWZWZWZWZWZWZWZWZWZWZWZWZWZWZWZWZWZWZWcw
TSTSTSTSTSTSTSTSTSTSTSTSTSTSTSTSTSTSTSvTvTcwcwcwcwZWZWZWvhvhvhZWUCPWPWPWPWPWUCPWPWPWPWPWPWPWPWPWPWUCZWUCPWPWPWPWPWUCZWUCPWPWPWPWPWPWPWPWUCZWZWvhvhvhZWZWZWZWZWZWZWZWZWZWZWZWZWZWZWZWZWZWZWZWcw
TSTSTSTSTSTSTSTSTSTSTSTSTSTSTSTSTSTSTSvTvTcwcwcwcwZWZWZWvhvhvhZWUCPWPWPWPWPWUCPWPWPWPWPWPWPWPWPWPWUCZWUCPWPWPWPWPWUCZWUCPWPWPWPWPWPWPWPWUCZWZWvhvhvhZWZWZWZWZWZWZWZWZWZWZWZWZWZWZWZWZWZWZWZWcw
TSTSTSTSTSTSTSTSTSTSTSTSTSTSTSTSTSTSTSvTvTcwcwcwcwZWZWZWvhvhvhZWUCPWPWPWPWPWUCPWPWPWPWPWPWPWPWPWPWUCZWUCPWPWPWPWPWUCZWUCPWPWPWPWPWPWPWPWUCZWZWvhvhvhZWZWZWZWZWZWZWZWZWZWZWZWZWZWZWZWZWZWZWZWcw
TSTSTSTSTSTSTSTSTSTSTSTSTSTSTSTSTSTSTSvTvTcwcwcwcwZWZWZWvhvhvhZWUCUCUCUCUCUCUCUCUCUCUCUCUCUCUCUCUCUCZWUCUCUCUCUCUCUCZWUCUCUCUCUCUCUCUCUCUCZWZWvhvhvhZWZWZWZWZWZWZWZWZWZWZWZWZWZWZWZWZWZWZWZWcw
TSTSTSTSTSTSTSTSTSTSTSTSTSTSTSTSTSTSTSvTvTcwcwcwcwZWZWZWvhvhvhZWZWZWZWZWZWZWZWZWZWZWZWZWZWZWZWZWZWZWZWZWZWZWZWZWZWZWZWZWZWZWZWZWZWZWZWZWZWZWZWvhvhvhZWZWZWZWZWZWZWZWZWZWZWZWZWZWZWZWZWZWZWZWcw
TSTSTSTSTSTSTSTSTSTSTSTSTSTSTSTSTSTSTSvTvTcwcwcwcwcwZWZWvhvhvhvhvhvhvhvhvhvhvhvhvhvhvhvhvhvhvhvhvhvhvhvhvhvhvhvhvhvhvhvhvhvhaaaaaaaavhvhvhvhvhvhvhvhZWZWZWZWZWZWZWZWZWZWZWZWZWZWZWZWZWZWZWZWcw
TSTSTSTSTSTSTSTSTSVjTSTSTSTSTSTSTSTSTSvTvTcwcwcwcwcwZWZWvhvhvhvhvhvhvhvhvhvhvhvhvhvhvhvhvhvhvhvhvhvhvhvhvhvhvhvhvhvhvhvhvhvhvhaaaaaaaavhvhvhvhvhvhvhZWZWZWZWZWZWZWZWZWZWZWZWZWZWZWZWZWZWZWcwcw
TSTSTSTSTSTSTSTSTSTSTSTSTSTSTSTSTSTSTSvTvTcwcwcwcwcwZWZWvhvhvhvhvhvhvhvhvhvhvhvhvhvhvhvhvhvhvhvhvhvhvhvhvhvhvhvhvhvhvhvhvhvhaaaaaaaaaavhvhvhvhvhvhvhZWZWZWZWZWZWZWZWZWZWZWZWZWZWZWZWZWZWZWcwcw
TSTSTSTSTSTSTSTSTSTSTSTSTSTSTSTSTSTSTSvTvTcwcwcwcwcwcwZWZWZWZWZWZWZWZWZWZWZWZWZWZWZWZWZWZWZWZWZWZWZWZWZWZWZWZWZWZWZWZWZWZWZWZWZWZWZWZWZWZWZWZWZWZWZWZWZWZWZWZWZWZWZWZWZWZWZWZWZWZWZWZWZWZWcwcw
TSTSTSTSTSTSTSTSTSTSTSTSTSTSTSTSTSTSTSvTvTcwcwcwcwcwcwcwcwZWZWZWZWZWZWZWZWZWZWZWZWZWZWZWZWZWZWZWZWZWZWZWZWZWZWZWZWZWZWZWZWZWZWZWZWZWZWZWZWZWZWZWZWZWZWZWZWZWZWZWZWZWZWZWZWZWZWZWZWZWZWZWZWcwcw
TSTSTSTSTSTSTSTSTSTSTSTSTSTSTSTSTSTSTSvTvTcwcwcwcwcwcwcwcwcwZWZWZWZWZWZWZWZWZWZWZWZWZWZWZWZWZWZWZWZWZWZWZWZWZWZWZWZWZWZWZWZWZWZWZWZWZWZWZWZWZWZWZWZWZWZWZWZWZWZWZWZWZWZWZWZWZWZWZWZWZWZWZWcwcw
TSTSTSTSTSTSTSTSTSTSTSTSTSTSTSTSTSTSTSvTvTcwcwcwcwcwcwcwcwcwcwcwcwZWZWZWZWZWcwcwcwZWZWZWZWZWZWZWZWZWZWZWZWZWZWZWZWZWZWZWZWZWZWZWZWZWZWZWZWZWZWZWZWZWZWZWZWZWZWZWZWZWcwZWZWZWZWZWZWZWZWcwcwcwcw
TSTSTSTSTSTSTSTSTSTSTSTSTSTSTSTSTSTSTSvTvTcwcwcwcwcwcwcwcwcwcwcwcwcwcwcwcwcwcwcwcwcwcwcwcwZWZWZWZWZWZWcwcwcwcwcwcwcwcwcwcwcwcwZWZWZWZWZWZWZWZWZWZWcwcwcwcwcwZWZWZWZWcwcwcwcwcwcwcwZWcwcwcwcwcw
PITSTSTSTSTSTSTSTSTSTSTSTSTSTSTSTSTSTSvTvTcwcwcwcwcwcwcwcwcwcwcwcwcwcwcwcwcwcwcwcwcwcwcwcwcwcwcwcwcwcwcwcwcwcwcwcwcwcwcwcwcwcwcwcwcwcwcwcwcwcwcwcwcwcwcwcwcwcwcwcwcwcwcwcwcwcwcwcwcwcwcwcwcwcw
"}
