//MAP CONVERTED BY dmm2tgm.py THIS HEADER COMMENT PREVENTS RECONVERSION, DO NOT REMOVE
"cw" = (
/turf/closed/indestructible/rock/ms13,
/area/space)
"vh" = (
/turf/closed/wall/ms13/concrete,
/area/space)
"vT" = (
/turf/closed/indestructible/rock/ms13,
/area/start)
"zg" = (
/turf/closed/wall/ms13/metal/reinforced,
/area/space)
"Eh" = (
/turf/open/floor/plating/ms13/ground/desertalt,
/area/space)
"FF" = (
/turf/open/floor/plating/ms13/ground/road,
/area/space)
"PI" = (
/turf/closed/indestructible/splashscreen,
/area/start)
"PW" = (
/turf/open/floor/ms13/concrete,
/area/space)
"St" = (
/turf/closed/wall/ms13/craftable/scrap,
/area/space)
"TS" = (
/turf/closed/indestructible/riveted,
/area/start)
"UC" = (
/turf/closed/wall/ms13/metal,
/area/space)
"Vj" = (
/obj/effect/landmark/start/new_player,
/turf/open/floor/plating,
/area/start)
"ZW" = (
/turf/open/floor/plating/ms13/ground/desert,
/area/space)

(1,1,1) = {"
cw
cw
cw
cw
cw
cw
cw
cw
cw
cw
cw
cw
cw
cw
cw
cw
cw
cw
cw
cw
cw
cw
cw
cw
cw
cw
cw
cw
cw
cw
cw
cw
cw
cw
cw
cw
cw
cw
cw
cw
cw
cw
cw
cw
cw
cw
cw
cw
cw
cw
cw
cw
cw
cw
cw
cw
cw
cw
cw
cw
cw
cw
cw
cw
cw
cw
cw
cw
cw
cw
cw
cw
cw
cw
cw
cw
cw
cw
cw
vT
TS
TS
TS
TS
TS
TS
TS
TS
TS
TS
TS
TS
TS
TS
PI
"}
(2,1,1) = {"
cw
cw
ZW
ZW
ZW
cw
cw
cw
cw
cw
cw
ZW
ZW
ZW
ZW
cw
cw
cw
cw
cw
cw
cw
cw
ZW
ZW
ZW
ZW
cw
cw
cw
cw
cw
ZW
ZW
FF
FF
FF
cw
cw
ZW
ZW
ZW
cw
cw
cw
ZW
ZW
cw
cw
cw
cw
cw
cw
ZW
ZW
ZW
cw
cw
cw
cw
ZW
ZW
ZW
cw
ZW
ZW
ZW
ZW
cw
cw
cw
cw
cw
cw
cw
cw
cw
cw
cw
vT
TS
TS
TS
TS
TS
TS
TS
TS
TS
TS
TS
TS
TS
TS
TS
"}
(3,1,1) = {"
cw
cw
ZW
ZW
ZW
ZW
ZW
ZW
ZW
ZW
ZW
ZW
ZW
ZW
ZW
ZW
ZW
ZW
ZW
cw
ZW
ZW
ZW
ZW
ZW
ZW
ZW
ZW
ZW
ZW
ZW
ZW
ZW
ZW
FF
FF
FF
ZW
ZW
ZW
ZW
ZW
ZW
ZW
ZW
ZW
ZW
ZW
ZW
ZW
ZW
ZW
ZW
ZW
ZW
ZW
ZW
cw
ZW
ZW
ZW
ZW
ZW
ZW
ZW
ZW
ZW
ZW
ZW
ZW
ZW
ZW
cw
cw
cw
cw
cw
cw
cw
vT
TS
TS
TS
TS
TS
TS
TS
TS
TS
TS
TS
TS
TS
TS
TS
"}
(4,1,1) = {"
cw
ZW
ZW
ZW
ZW
ZW
ZW
ZW
ZW
ZW
ZW
ZW
ZW
ZW
ZW
ZW
ZW
ZW
ZW
ZW
ZW
ZW
ZW
ZW
ZW
ZW
ZW
ZW
ZW
ZW
ZW
ZW
ZW
ZW
FF
FF
FF
ZW
ZW
ZW
ZW
ZW
ZW
ZW
ZW
ZW
ZW
ZW
ZW
ZW
ZW
ZW
ZW
ZW
ZW
ZW
ZW
ZW
ZW
ZW
ZW
ZW
ZW
ZW
ZW
ZW
ZW
ZW
ZW
ZW
ZW
ZW
cw
cw
cw
cw
cw
cw
cw
vT
TS
TS
TS
TS
TS
TS
TS
TS
TS
TS
TS
TS
TS
TS
TS
"}
(5,1,1) = {"
cw
ZW
ZW
ZW
ZW
ZW
ZW
ZW
ZW
ZW
ZW
ZW
ZW
ZW
ZW
ZW
ZW
ZW
ZW
ZW
ZW
ZW
ZW
ZW
ZW
ZW
ZW
ZW
ZW
ZW
ZW
ZW
ZW
ZW
FF
FF
FF
ZW
ZW
ZW
ZW
ZW
ZW
ZW
ZW
ZW
ZW
ZW
ZW
ZW
ZW
ZW
ZW
ZW
ZW
ZW
ZW
ZW
ZW
ZW
ZW
ZW
ZW
ZW
ZW
ZW
ZW
ZW
ZW
ZW
ZW
ZW
cw
cw
cw
cw
cw
cw
cw
vT
TS
TS
TS
TS
TS
TS
TS
TS
TS
TS
TS
TS
TS
TS
TS
"}
(6,1,1) = {"
cw
ZW
ZW
ZW
ZW
ZW
ZW
ZW
ZW
ZW
ZW
ZW
ZW
ZW
ZW
ZW
ZW
ZW
ZW
ZW
ZW
ZW
ZW
ZW
ZW
ZW
ZW
ZW
ZW
ZW
ZW
ZW
ZW
ZW
FF
FF
FF
ZW
ZW
ZW
ZW
ZW
ZW
ZW
ZW
ZW
ZW
ZW
ZW
ZW
ZW
ZW
ZW
ZW
ZW
ZW
ZW
ZW
ZW
ZW
ZW
ZW
ZW
ZW
ZW
ZW
ZW
ZW
ZW
ZW
ZW
ZW
cw
cw
cw
cw
cw
cw
cw
vT
TS
TS
TS
TS
TS
TS
TS
TS
TS
TS
TS
TS
TS
TS
TS
"}
(7,1,1) = {"
cw
ZW
ZW
ZW
ZW
ZW
ZW
ZW
ZW
ZW
ZW
ZW
ZW
ZW
ZW
ZW
ZW
ZW
ZW
ZW
ZW
ZW
ZW
ZW
ZW
ZW
ZW
ZW
ZW
ZW
ZW
ZW
ZW
ZW
FF
FF
FF
ZW
ZW
ZW
ZW
ZW
ZW
ZW
ZW
ZW
ZW
ZW
ZW
ZW
ZW
ZW
ZW
ZW
ZW
ZW
ZW
ZW
ZW
ZW
ZW
ZW
ZW
ZW
ZW
ZW
ZW
ZW
ZW
ZW
ZW
ZW
cw
cw
cw
cw
cw
cw
cw
vT
TS
TS
TS
TS
TS
TS
TS
TS
TS
TS
TS
TS
TS
TS
TS
"}
(8,1,1) = {"
cw
ZW
ZW
ZW
ZW
vh
vh
vh
vh
vh
vh
vh
vh
vh
St
St
St
St
St
St
St
vh
vh
vh
vh
vh
vh
vh
vh
vh
vh
zg
zg
ZW
FF
FF
FF
ZW
zg
zg
vh
vh
vh
vh
vh
vh
vh
vh
vh
vh
vh
vh
vh
vh
vh
vh
vh
vh
vh
vh
vh
vh
vh
vh
vh
vh
vh
vh
vh
ZW
ZW
ZW
ZW
cw
cw
cw
cw
cw
cw
vT
TS
TS
TS
TS
TS
TS
TS
TS
TS
TS
TS
TS
TS
TS
TS
"}
(9,1,1) = {"
cw
ZW
ZW
ZW
ZW
vh
vh
vh
vh
vh
vh
vh
vh
vh
vh
vh
St
St
St
St
St
St
St
vh
vh
vh
vh
vh
vh
vh
vh
vh
zg
ZW
FF
FF
FF
ZW
zg
vh
vh
vh
vh
vh
vh
vh
vh
vh
vh
vh
vh
vh
vh
vh
vh
vh
vh
vh
vh
vh
vh
vh
vh
vh
vh
vh
vh
vh
vh
ZW
ZW
ZW
ZW
ZW
cw
cw
cw
cw
cw
vT
TS
TS
TS
TS
TS
TS
TS
TS
TS
TS
TS
TS
TS
TS
TS
"}
(10,1,1) = {"
cw
ZW
ZW
ZW
ZW
vh
vh
vh
vh
vh
vh
vh
vh
vh
vh
vh
vh
St
St
St
St
St
St
vh
vh
vh
vh
vh
vh
vh
vh
zg
zg
ZW
FF
FF
FF
ZW
zg
zg
vh
vh
vh
vh
vh
vh
vh
vh
vh
vh
vh
vh
vh
vh
vh
vh
vh
vh
vh
vh
vh
vh
vh
vh
vh
vh
vh
vh
vh
ZW
ZW
ZW
ZW
cw
cw
cw
cw
cw
cw
vT
TS
TS
TS
TS
TS
TS
TS
Vj
TS
TS
TS
TS
TS
TS
TS
"}
(11,1,1) = {"
cw
ZW
ZW
ZW
ZW
vh
vh
vh
ZW
ZW
ZW
ZW
ZW
ZW
ZW
ZW
ZW
ZW
ZW
ZW
ZW
ZW
ZW
ZW
ZW
ZW
ZW
ZW
ZW
ZW
ZW
ZW
ZW
ZW
FF
FF
FF
ZW
ZW
ZW
ZW
ZW
ZW
ZW
ZW
ZW
ZW
ZW
ZW
ZW
ZW
ZW
ZW
ZW
ZW
ZW
ZW
ZW
ZW
ZW
ZW
ZW
ZW
ZW
ZW
ZW
vh
vh
vh
ZW
ZW
ZW
ZW
ZW
cw
cw
cw
cw
cw
vT
TS
TS
TS
TS
TS
TS
TS
TS
TS
TS
TS
TS
TS
TS
TS
"}
(12,1,1) = {"
cw
cw
ZW
ZW
ZW
vh
vh
vh
ZW
ZW
ZW
ZW
ZW
ZW
ZW
ZW
ZW
ZW
ZW
ZW
ZW
ZW
ZW
ZW
ZW
ZW
ZW
ZW
ZW
ZW
ZW
ZW
ZW
ZW
FF
FF
FF
ZW
ZW
ZW
ZW
ZW
ZW
ZW
ZW
ZW
ZW
ZW
ZW
ZW
ZW
ZW
ZW
ZW
ZW
ZW
ZW
ZW
ZW
ZW
ZW
ZW
ZW
ZW
ZW
ZW
vh
vh
vh
ZW
ZW
ZW
ZW
ZW
cw
cw
cw
cw
cw
vT
TS
TS
TS
TS
TS
TS
TS
TS
TS
TS
TS
TS
TS
TS
TS
"}
(13,1,1) = {"
cw
cw
ZW
ZW
ZW
vh
vh
vh
ZW
ZW
ZW
ZW
ZW
ZW
ZW
ZW
ZW
ZW
ZW
ZW
ZW
ZW
ZW
ZW
ZW
ZW
ZW
ZW
ZW
ZW
ZW
ZW
ZW
ZW
FF
FF
FF
ZW
ZW
ZW
ZW
ZW
ZW
ZW
ZW
ZW
ZW
ZW
ZW
ZW
ZW
ZW
ZW
ZW
ZW
ZW
ZW
ZW
ZW
ZW
ZW
ZW
ZW
ZW
ZW
ZW
vh
vh
vh
ZW
ZW
ZW
ZW
ZW
cw
cw
cw
cw
cw
vT
TS
TS
TS
TS
TS
TS
TS
TS
TS
TS
TS
TS
TS
TS
TS
"}
(14,1,1) = {"
cw
cw
ZW
ZW
ZW
vh
vh
vh
ZW
ZW
ZW
ZW
ZW
ZW
ZW
ZW
ZW
ZW
ZW
ZW
ZW
ZW
ZW
ZW
ZW
ZW
ZW
ZW
ZW
ZW
ZW
ZW
ZW
ZW
FF
FF
FF
ZW
ZW
ZW
ZW
ZW
ZW
ZW
ZW
ZW
ZW
ZW
ZW
ZW
ZW
ZW
ZW
ZW
ZW
ZW
ZW
ZW
ZW
ZW
ZW
ZW
ZW
ZW
ZW
ZW
vh
vh
vh
ZW
ZW
ZW
ZW
ZW
cw
cw
cw
cw
cw
vT
TS
TS
TS
TS
TS
TS
TS
TS
TS
TS
TS
TS
TS
TS
TS
"}
(15,1,1) = {"
cw
cw
ZW
ZW
ZW
vh
vh
vh
ZW
ZW
ZW
FF
FF
FF
FF
FF
FF
FF
FF
FF
FF
FF
FF
FF
FF
FF
FF
FF
FF
FF
FF
FF
FF
FF
FF
FF
FF
FF
FF
FF
FF
FF
FF
FF
FF
FF
FF
FF
FF
FF
FF
FF
FF
FF
FF
FF
FF
FF
FF
FF
FF
FF
FF
FF
ZW
ZW
vh
vh
vh
ZW
ZW
ZW
ZW
ZW
ZW
cw
cw
cw
cw
vT
TS
TS
TS
TS
TS
TS
TS
TS
TS
TS
TS
TS
TS
TS
TS
"}
(16,1,1) = {"
cw
cw
ZW
ZW
ZW
vh
vh
vh
ZW
ZW
ZW
FF
FF
FF
FF
FF
FF
FF
FF
FF
FF
FF
FF
FF
FF
FF
FF
FF
FF
FF
FF
FF
FF
FF
FF
FF
FF
FF
FF
FF
FF
FF
FF
FF
FF
FF
FF
FF
FF
FF
FF
FF
FF
FF
FF
FF
FF
FF
FF
FF
FF
FF
FF
FF
ZW
ZW
vh
vh
vh
ZW
ZW
ZW
ZW
ZW
ZW
cw
cw
cw
cw
vT
TS
TS
TS
TS
TS
TS
TS
TS
TS
TS
TS
TS
TS
TS
TS
"}
(17,1,1) = {"
cw
cw
ZW
ZW
ZW
vh
vh
vh
ZW
ZW
ZW
FF
FF
FF
FF
FF
FF
FF
FF
FF
FF
FF
FF
FF
FF
FF
FF
FF
FF
FF
FF
FF
FF
FF
FF
FF
FF
FF
FF
FF
FF
FF
FF
FF
FF
FF
FF
FF
FF
FF
FF
FF
FF
FF
FF
FF
FF
FF
FF
FF
FF
FF
FF
FF
ZW
ZW
vh
vh
vh
ZW
ZW
ZW
ZW
ZW
ZW
cw
cw
cw
cw
vT
TS
TS
TS
TS
TS
TS
TS
TS
TS
TS
TS
TS
TS
TS
TS
"}
(18,1,1) = {"
cw
cw
ZW
ZW
ZW
vh
vh
vh
ZW
ZW
ZW
FF
FF
FF
ZW
ZW
ZW
ZW
ZW
ZW
ZW
ZW
ZW
ZW
ZW
ZW
ZW
ZW
ZW
ZW
ZW
ZW
ZW
ZW
FF
FF
FF
ZW
ZW
ZW
ZW
ZW
ZW
ZW
ZW
ZW
ZW
ZW
ZW
ZW
ZW
ZW
ZW
ZW
ZW
ZW
ZW
ZW
ZW
ZW
ZW
FF
FF
FF
ZW
ZW
vh
vh
vh
ZW
ZW
ZW
ZW
ZW
ZW
cw
cw
cw
cw
vT
TS
TS
TS
TS
TS
TS
TS
TS
TS
TS
TS
TS
TS
TS
TS
"}
(19,1,1) = {"
cw
cw
ZW
ZW
ZW
vh
vh
vh
ZW
ZW
ZW
FF
FF
FF
ZW
UC
UC
UC
UC
UC
UC
UC
UC
UC
UC
ZW
UC
UC
UC
UC
UC
UC
UC
ZW
FF
FF
FF
ZW
UC
UC
UC
UC
UC
UC
UC
UC
UC
UC
UC
ZW
UC
UC
UC
UC
UC
UC
UC
UC
UC
UC
ZW
FF
FF
FF
ZW
ZW
vh
vh
vh
ZW
ZW
ZW
ZW
ZW
ZW
ZW
cw
cw
cw
vT
TS
TS
TS
TS
TS
TS
TS
TS
TS
TS
TS
TS
TS
TS
TS
"}
(20,1,1) = {"
cw
cw
ZW
ZW
ZW
vh
vh
vh
ZW
ZW
ZW
FF
FF
FF
ZW
UC
PW
PW
PW
PW
PW
PW
PW
PW
UC
ZW
UC
PW
PW
PW
PW
PW
UC
ZW
FF
FF
FF
ZW
UC
PW
PW
PW
PW
PW
PW
PW
PW
PW
UC
ZW
UC
PW
PW
PW
PW
PW
PW
PW
PW
UC
ZW
FF
FF
FF
ZW
ZW
vh
vh
vh
ZW
ZW
ZW
ZW
ZW
ZW
ZW
cw
cw
cw
vT
vT
vT
vT
vT
vT
vT
vT
vT
vT
vT
vT
vT
vT
vT
vT
"}
(21,1,1) = {"
cw
cw
ZW
ZW
ZW
vh
vh
vh
ZW
ZW
ZW
FF
FF
FF
ZW
UC
PW
PW
PW
PW
PW
PW
PW
PW
UC
ZW
UC
PW
PW
PW
PW
PW
UC
ZW
FF
FF
FF
ZW
UC
PW
PW
PW
PW
PW
PW
PW
PW
PW
UC
ZW
UC
PW
PW
PW
PW
PW
PW
PW
PW
UC
ZW
FF
FF
FF
ZW
ZW
vh
vh
vh
ZW
ZW
ZW
ZW
ZW
ZW
ZW
cw
cw
cw
vT
vT
vT
vT
vT
vT
vT
vT
vT
vT
vT
vT
vT
vT
vT
vT
"}
(22,1,1) = {"
cw
cw
ZW
ZW
ZW
vh
vh
vh
ZW
ZW
ZW
FF
FF
FF
ZW
UC
PW
PW
PW
PW
PW
PW
PW
PW
UC
ZW
UC
PW
PW
PW
PW
PW
UC
ZW
FF
FF
FF
ZW
UC
PW
PW
PW
PW
PW
PW
PW
PW
PW
UC
ZW
UC
PW
PW
PW
PW
PW
PW
PW
PW
UC
ZW
FF
FF
FF
ZW
ZW
vh
vh
vh
ZW
ZW
ZW
ZW
ZW
ZW
ZW
ZW
cw
cw
cw
cw
cw
cw
cw
cw
cw
cw
cw
cw
cw
cw
cw
cw
cw
cw
"}
(23,1,1) = {"
cw
cw
ZW
ZW
ZW
vh
vh
vh
ZW
ZW
ZW
FF
FF
FF
ZW
UC
PW
PW
PW
PW
PW
PW
PW
PW
UC
ZW
UC
PW
PW
PW
PW
PW
UC
ZW
FF
FF
FF
ZW
UC
PW
PW
PW
PW
PW
PW
PW
PW
PW
UC
ZW
UC
PW
PW
PW
PW
PW
PW
PW
PW
UC
ZW
FF
FF
FF
ZW
ZW
vh
vh
vh
ZW
ZW
ZW
ZW
ZW
ZW
ZW
ZW
ZW
cw
cw
cw
cw
cw
cw
cw
cw
cw
cw
cw
cw
cw
cw
cw
cw
cw
"}
(24,1,1) = {"
cw
cw
ZW
ZW
ZW
vh
vh
vh
ZW
ZW
ZW
FF
FF
FF
ZW
UC
PW
PW
PW
PW
UC
UC
UC
UC
UC
ZW
UC
PW
PW
PW
PW
PW
UC
ZW
FF
FF
FF
ZW
UC
PW
PW
PW
PW
PW
PW
PW
PW
PW
UC
ZW
UC
PW
PW
PW
PW
PW
PW
PW
PW
UC
ZW
FF
FF
FF
ZW
ZW
vh
vh
vh
ZW
ZW
ZW
ZW
ZW
ZW
ZW
ZW
ZW
ZW
cw
cw
cw
cw
cw
cw
cw
cw
cw
cw
cw
cw
cw
cw
cw
cw
"}
(25,1,1) = {"
cw
cw
ZW
ZW
ZW
vh
vh
vh
ZW
ZW
ZW
FF
FF
FF
ZW
UC
PW
PW
PW
PW
UC
ZW
ZW
ZW
ZW
ZW
UC
PW
PW
PW
PW
PW
UC
ZW
FF
FF
FF
ZW
UC
PW
PW
PW
PW
PW
PW
PW
PW
PW
UC
ZW
UC
PW
PW
PW
PW
PW
PW
PW
PW
UC
ZW
FF
FF
FF
ZW
ZW
vh
vh
vh
ZW
ZW
ZW
ZW
ZW
ZW
ZW
ZW
ZW
ZW
ZW
ZW
cw
cw
cw
cw
cw
cw
cw
cw
cw
cw
cw
cw
cw
cw
"}
(26,1,1) = {"
cw
cw
ZW
ZW
ZW
vh
vh
vh
ZW
ZW
ZW
FF
FF
FF
ZW
UC
PW
PW
PW
PW
UC
ZW
ZW
ZW
ZW
ZW
UC
PW
PW
PW
PW
PW
UC
ZW
FF
FF
FF
ZW
UC
UC
UC
UC
UC
UC
UC
UC
UC
UC
UC
ZW
UC
UC
UC
UC
UC
UC
UC
UC
UC
UC
ZW
FF
FF
FF
ZW
ZW
vh
vh
St
ZW
ZW
ZW
ZW
ZW
ZW
ZW
ZW
ZW
ZW
ZW
ZW
ZW
ZW
ZW
ZW
ZW
cw
cw
cw
cw
cw
cw
cw
cw
cw
"}
(27,1,1) = {"
cw
cw
ZW
ZW
ZW
vh
vh
vh
ZW
ZW
ZW
FF
FF
FF
ZW
UC
PW
PW
PW
PW
UC
ZW
ZW
ZW
ZW
ZW
UC
UC
UC
UC
UC
UC
UC
ZW
FF
FF
FF
ZW
ZW
ZW
ZW
ZW
ZW
ZW
ZW
ZW
ZW
ZW
ZW
ZW
ZW
ZW
ZW
ZW
ZW
ZW
ZW
ZW
ZW
ZW
ZW
FF
FF
FF
ZW
ZW
St
St
St
ZW
ZW
ZW
ZW
ZW
ZW
ZW
ZW
ZW
ZW
ZW
ZW
ZW
ZW
ZW
ZW
ZW
ZW
ZW
ZW
cw
cw
cw
cw
cw
cw
"}
(28,1,1) = {"
cw
ZW
ZW
ZW
ZW
vh
vh
vh
ZW
ZW
ZW
FF
FF
FF
ZW
UC
PW
PW
PW
PW
UC
ZW
ZW
ZW
ZW
ZW
ZW
ZW
ZW
ZW
ZW
ZW
ZW
ZW
FF
FF
FF
ZW
UC
UC
UC
UC
UC
UC
UC
ZW
ZW
ZW
ZW
ZW
Eh
Eh
Eh
Eh
Eh
Eh
Eh
Eh
Eh
Eh
Eh
FF
FF
FF
ZW
ZW
St
St
St
ZW
ZW
ZW
ZW
ZW
ZW
ZW
ZW
ZW
ZW
ZW
ZW
ZW
ZW
ZW
ZW
ZW
ZW
ZW
ZW
ZW
cw
cw
cw
cw
cw
"}
(29,1,1) = {"
cw
ZW
ZW
ZW
ZW
vh
vh
vh
ZW
ZW
ZW
FF
FF
FF
ZW
UC
PW
PW
PW
PW
UC
ZW
ZW
ZW
ZW
ZW
ZW
ZW
ZW
ZW
ZW
ZW
ZW
ZW
FF
FF
FF
ZW
UC
PW
PW
PW
PW
PW
UC
ZW
ZW
ZW
ZW
ZW
Eh
Eh
Eh
Eh
Eh
Eh
Eh
Eh
Eh
Eh
ZW
FF
FF
FF
ZW
ZW
vh
St
St
St
St
St
vh
vh
vh
vh
vh
vh
vh
vh
vh
vh
vh
vh
vh
vh
vh
vh
vh
ZW
cw
cw
cw
cw
cw
"}
(30,1,1) = {"
cw
ZW
ZW
ZW
ZW
vh
vh
vh
ZW
ZW
ZW
FF
FF
FF
ZW
UC
PW
PW
PW
PW
UC
ZW
ZW
ZW
ZW
ZW
UC
UC
UC
UC
UC
UC
UC
ZW
FF
FF
FF
ZW
UC
PW
PW
PW
PW
PW
UC
ZW
ZW
ZW
ZW
Eh
Eh
UC
UC
UC
UC
UC
UC
UC
UC
UC
ZW
FF
FF
FF
ZW
ZW
vh
vh
St
St
St
St
St
vh
vh
vh
vh
vh
vh
vh
vh
vh
vh
vh
vh
vh
vh
vh
vh
ZW
ZW
cw
cw
cw
cw
"}
(31,1,1) = {"
cw
ZW
ZW
ZW
ZW
vh
vh
vh
ZW
ZW
ZW
FF
FF
FF
ZW
UC
PW
PW
PW
PW
UC
ZW
ZW
ZW
ZW
ZW
UC
PW
PW
PW
PW
PW
UC
ZW
FF
FF
FF
ZW
UC
PW
PW
PW
PW
PW
UC
ZW
ZW
ZW
ZW
Eh
ZW
UC
PW
PW
PW
PW
PW
PW
PW
UC
ZW
FF
FF
FF
ZW
ZW
vh
vh
vh
St
St
vh
vh
vh
vh
vh
vh
vh
vh
vh
vh
vh
vh
vh
vh
vh
vh
vh
vh
ZW
ZW
ZW
cw
cw
cw
"}
(32,1,1) = {"
cw
ZW
ZW
ZW
ZW
vh
vh
vh
ZW
ZW
ZW
FF
FF
FF
ZW
UC
PW
PW
PW
PW
UC
ZW
ZW
ZW
ZW
ZW
UC
PW
PW
PW
PW
PW
UC
ZW
FF
FF
FF
ZW
UC
PW
PW
PW
PW
PW
UC
ZW
ZW
ZW
ZW
Eh
ZW
UC
PW
PW
PW
PW
PW
PW
PW
UC
ZW
FF
FF
FF
ZW
ZW
ZW
ZW
ZW
ZW
ZW
ZW
ZW
ZW
ZW
ZW
ZW
ZW
ZW
ZW
ZW
ZW
ZW
ZW
ZW
ZW
vh
vh
vh
ZW
ZW
ZW
cw
cw
cw
"}
(33,1,1) = {"
cw
ZW
ZW
ZW
ZW
vh
vh
vh
ZW
ZW
ZW
FF
FF
FF
ZW
UC
PW
PW
PW
PW
UC
ZW
ZW
ZW
ZW
ZW
UC
PW
PW
PW
PW
PW
UC
ZW
FF
FF
FF
ZW
UC
PW
PW
PW
PW
PW
UC
ZW
ZW
ZW
Eh
Eh
ZW
UC
PW
PW
PW
PW
PW
PW
PW
UC
ZW
FF
FF
FF
ZW
UC
UC
UC
UC
UC
UC
UC
UC
ZW
ZW
UC
UC
UC
UC
UC
UC
UC
UC
UC
UC
ZW
vh
vh
vh
ZW
ZW
ZW
cw
cw
cw
"}
(34,1,1) = {"
cw
ZW
ZW
ZW
ZW
vh
vh
vh
ZW
ZW
ZW
FF
FF
FF
ZW
UC
UC
UC
UC
UC
UC
ZW
ZW
ZW
ZW
ZW
UC
PW
PW
PW
PW
PW
UC
ZW
FF
FF
FF
ZW
UC
PW
PW
PW
PW
PW
UC
ZW
ZW
Eh
Eh
ZW
ZW
UC
PW
PW
PW
PW
PW
PW
PW
UC
ZW
FF
FF
FF
ZW
UC
PW
PW
PW
PW
PW
PW
UC
ZW
ZW
UC
PW
PW
PW
PW
PW
PW
PW
PW
UC
ZW
vh
vh
vh
ZW
ZW
ZW
ZW
cw
cw
"}
(35,1,1) = {"
cw
ZW
ZW
ZW
ZW
vh
vh
vh
ZW
ZW
ZW
FF
FF
FF
ZW
ZW
ZW
ZW
ZW
ZW
ZW
ZW
ZW
ZW
ZW
ZW
UC
PW
PW
PW
PW
PW
UC
ZW
FF
FF
FF
ZW
UC
PW
PW
PW
PW
PW
UC
ZW
ZW
Eh
Eh
ZW
ZW
UC
PW
PW
PW
PW
PW
PW
PW
UC
ZW
FF
FF
FF
ZW
UC
PW
PW
PW
PW
PW
PW
UC
ZW
ZW
UC
PW
PW
PW
PW
PW
PW
PW
PW
UC
ZW
vh
vh
vh
ZW
ZW
ZW
ZW
cw
cw
"}
(36,1,1) = {"
cw
cw
ZW
ZW
ZW
vh
vh
vh
ZW
ZW
ZW
FF
FF
FF
ZW
ZW
ZW
ZW
ZW
ZW
ZW
ZW
ZW
ZW
ZW
ZW
UC
PW
PW
PW
PW
PW
UC
ZW
FF
FF
FF
ZW
UC
PW
PW
PW
PW
PW
UC
ZW
Eh
Eh
ZW
ZW
ZW
UC
PW
PW
PW
PW
PW
PW
PW
UC
ZW
FF
FF
FF
ZW
UC
PW
PW
PW
PW
PW
PW
UC
ZW
ZW
UC
PW
PW
PW
PW
PW
PW
PW
PW
UC
ZW
vh
vh
vh
ZW
ZW
ZW
ZW
cw
cw
"}
(37,1,1) = {"
cw
cw
ZW
ZW
ZW
vh
vh
vh
ZW
ZW
ZW
FF
FF
FF
ZW
ZW
ZW
ZW
ZW
ZW
ZW
ZW
ZW
ZW
ZW
ZW
UC
PW
PW
PW
PW
PW
UC
ZW
FF
FF
FF
ZW
UC
UC
UC
UC
UC
UC
UC
ZW
Eh
Eh
ZW
ZW
ZW
UC
PW
PW
PW
PW
PW
PW
PW
UC
ZW
FF
FF
FF
ZW
UC
UC
UC
UC
UC
UC
UC
UC
ZW
ZW
UC
UC
UC
UC
PW
PW
PW
PW
PW
UC
ZW
vh
vh
vh
ZW
ZW
ZW
ZW
cw
cw
"}
(38,1,1) = {"
cw
cw
ZW
ZW
ZW
vh
vh
vh
ZW
ZW
ZW
FF
FF
FF
ZW
ZW
ZW
ZW
ZW
ZW
ZW
ZW
ZW
ZW
ZW
ZW
UC
PW
PW
PW
PW
PW
UC
ZW
FF
FF
FF
Eh
Eh
Eh
Eh
Eh
Eh
Eh
Eh
Eh
Eh
Eh
ZW
ZW
ZW
UC
PW
PW
PW
PW
PW
PW
PW
UC
ZW
FF
FF
FF
ZW
ZW
ZW
ZW
ZW
ZW
ZW
ZW
ZW
ZW
ZW
ZW
ZW
ZW
UC
PW
PW
PW
PW
PW
UC
ZW
vh
vh
vh
ZW
ZW
ZW
ZW
cw
cw
"}
(39,1,1) = {"
cw
cw
ZW
ZW
ZW
vh
vh
vh
ZW
ZW
ZW
FF
FF
FF
ZW
ZW
ZW
ZW
ZW
ZW
ZW
ZW
ZW
ZW
ZW
ZW
UC
PW
PW
PW
PW
PW
UC
ZW
FF
FF
FF
ZW
UC
UC
UC
UC
UC
UC
Eh
Eh
Eh
Eh
Eh
ZW
ZW
UC
PW
PW
PW
PW
PW
PW
PW
UC
ZW
FF
FF
FF
FF
FF
FF
FF
FF
FF
FF
FF
FF
FF
FF
FF
FF
ZW
UC
UC
UC
UC
UC
UC
UC
ZW
vh
vh
vh
ZW
ZW
ZW
cw
cw
cw
"}
(40,1,1) = {"
cw
cw
ZW
ZW
ZW
vh
vh
vh
ZW
ZW
ZW
FF
FF
FF
ZW
ZW
ZW
ZW
ZW
ZW
ZW
ZW
ZW
ZW
ZW
ZW
UC
PW
PW
PW
PW
PW
UC
ZW
FF
FF
FF
ZW
UC
PW
PW
PW
PW
UC
ZW
ZW
Eh
Eh
Eh
Eh
ZW
UC
PW
PW
PW
PW
PW
PW
PW
UC
ZW
FF
FF
FF
FF
FF
FF
FF
FF
FF
FF
FF
FF
FF
FF
FF
FF
ZW
UC
PW
PW
PW
PW
PW
UC
ZW
vh
vh
vh
ZW
ZW
ZW
cw
cw
cw
"}
(41,1,1) = {"
cw
cw
ZW
ZW
ZW
vh
vh
vh
ZW
ZW
ZW
FF
FF
FF
ZW
UC
UC
UC
UC
UC
UC
ZW
ZW
ZW
ZW
ZW
UC
PW
PW
PW
PW
PW
UC
ZW
FF
FF
FF
ZW
UC
PW
PW
PW
PW
UC
ZW
ZW
ZW
Eh
Eh
Eh
Eh
UC
PW
PW
PW
PW
PW
PW
PW
UC
ZW
FF
FF
FF
FF
FF
FF
FF
FF
FF
FF
FF
FF
FF
FF
FF
FF
ZW
UC
PW
PW
PW
PW
PW
UC
ZW
vh
vh
vh
ZW
ZW
ZW
cw
cw
cw
"}
(42,1,1) = {"
cw
cw
ZW
ZW
ZW
vh
vh
vh
ZW
ZW
ZW
FF
FF
FF
ZW
UC
PW
PW
PW
PW
UC
ZW
ZW
ZW
ZW
ZW
UC
UC
UC
UC
UC
UC
UC
ZW
FF
FF
FF
ZW
UC
PW
PW
PW
PW
UC
ZW
ZW
ZW
Eh
Eh
Eh
Eh
UC
PW
PW
PW
PW
PW
PW
PW
UC
ZW
ZW
ZW
ZW
ZW
ZW
ZW
ZW
ZW
ZW
ZW
ZW
ZW
ZW
FF
FF
FF
ZW
UC
PW
PW
PW
PW
PW
UC
ZW
vh
vh
vh
ZW
ZW
ZW
ZW
cw
cw
"}
(43,1,1) = {"
cw
cw
ZW
ZW
ZW
vh
vh
vh
ZW
ZW
ZW
FF
FF
FF
ZW
UC
PW
PW
PW
PW
UC
ZW
ZW
ZW
ZW
ZW
ZW
ZW
ZW
ZW
ZW
ZW
ZW
ZW
FF
FF
FF
ZW
UC
PW
PW
PW
PW
UC
ZW
ZW
ZW
ZW
ZW
Eh
Eh
UC
PW
PW
PW
PW
PW
PW
PW
UC
UC
UC
UC
UC
UC
UC
UC
UC
UC
ZW
ZW
ZW
ZW
ZW
FF
FF
FF
ZW
UC
PW
PW
PW
PW
PW
UC
ZW
vh
vh
vh
ZW
ZW
ZW
ZW
cw
cw
"}
(44,1,1) = {"
cw
cw
ZW
ZW
ZW
vh
vh
vh
ZW
ZW
ZW
FF
FF
FF
ZW
UC
PW
PW
PW
PW
UC
ZW
ZW
ZW
ZW
ZW
ZW
ZW
ZW
ZW
ZW
ZW
ZW
ZW
FF
FF
FF
ZW
UC
PW
PW
PW
PW
UC
UC
UC
UC
UC
UC
UC
Eh
UC
PW
PW
PW
PW
PW
PW
PW
PW
PW
PW
PW
PW
PW
PW
PW
PW
UC
ZW
ZW
ZW
ZW
ZW
FF
FF
FF
ZW
UC
PW
PW
PW
PW
PW
UC
ZW
vh
vh
vh
ZW
ZW
ZW
ZW
cw
cw
"}
(45,1,1) = {"
cw
cw
ZW
ZW
ZW
vh
vh
vh
ZW
ZW
ZW
FF
FF
FF
ZW
UC
PW
PW
PW
PW
UC
UC
UC
UC
ZW
ZW
ZW
ZW
ZW
ZW
ZW
ZW
ZW
ZW
FF
FF
FF
ZW
UC
PW
PW
PW
PW
PW
PW
PW
PW
PW
PW
UC
Eh
UC
PW
PW
PW
PW
PW
PW
PW
PW
PW
PW
PW
PW
PW
PW
PW
PW
UC
ZW
ZW
ZW
ZW
ZW
FF
FF
FF
ZW
UC
PW
PW
PW
PW
PW
UC
ZW
vh
vh
vh
ZW
ZW
ZW
ZW
cw
cw
"}
(46,1,1) = {"
cw
cw
ZW
ZW
ZW
vh
vh
vh
ZW
ZW
ZW
FF
FF
FF
ZW
UC
PW
PW
PW
PW
PW
PW
PW
UC
ZW
ZW
UC
UC
UC
UC
UC
UC
UC
ZW
FF
FF
FF
ZW
UC
PW
PW
PW
PW
PW
PW
PW
PW
PW
PW
UC
Eh
UC
PW
PW
PW
PW
PW
PW
PW
PW
PW
PW
PW
PW
PW
PW
PW
PW
UC
ZW
ZW
ZW
ZW
ZW
FF
FF
FF
ZW
UC
PW
PW
PW
PW
PW
UC
ZW
vh
vh
vh
ZW
ZW
ZW
ZW
ZW
cw
"}
(47,1,1) = {"
cw
cw
ZW
ZW
ZW
vh
vh
vh
ZW
ZW
ZW
FF
FF
FF
ZW
UC
PW
PW
PW
PW
PW
PW
PW
UC
ZW
ZW
UC
PW
PW
PW
PW
PW
UC
ZW
FF
FF
FF
ZW
UC
PW
PW
PW
PW
PW
PW
PW
PW
PW
PW
UC
Eh
UC
PW
PW
PW
PW
PW
PW
PW
PW
PW
PW
PW
PW
PW
PW
PW
PW
UC
ZW
ZW
ZW
ZW
ZW
FF
FF
FF
ZW
UC
PW
PW
PW
PW
PW
UC
ZW
vh
vh
vh
ZW
ZW
ZW
ZW
ZW
cw
"}
(48,1,1) = {"
cw
cw
ZW
ZW
ZW
vh
vh
vh
ZW
ZW
ZW
FF
FF
FF
ZW
UC
PW
PW
PW
PW
PW
PW
PW
UC
ZW
ZW
UC
PW
PW
PW
PW
PW
UC
ZW
FF
FF
FF
ZW
UC
PW
PW
PW
PW
PW
PW
PW
PW
PW
PW
UC
Eh
UC
UC
UC
UC
UC
UC
UC
UC
UC
UC
UC
UC
UC
UC
UC
UC
UC
UC
ZW
ZW
ZW
ZW
ZW
FF
FF
FF
ZW
UC
PW
PW
PW
PW
PW
UC
ZW
vh
vh
vh
ZW
ZW
ZW
ZW
ZW
cw
"}
(49,1,1) = {"
cw
cw
ZW
ZW
ZW
St
vh
vh
ZW
ZW
ZW
FF
FF
FF
ZW
UC
PW
PW
PW
PW
PW
PW
PW
UC
ZW
ZW
UC
PW
PW
PW
PW
PW
UC
ZW
FF
FF
FF
ZW
UC
PW
PW
PW
PW
PW
PW
PW
PW
PW
PW
UC
Eh
Eh
ZW
ZW
ZW
ZW
ZW
ZW
ZW
ZW
ZW
ZW
ZW
ZW
ZW
ZW
ZW
ZW
ZW
ZW
ZW
ZW
ZW
ZW
FF
FF
FF
ZW
UC
PW
PW
PW
PW
PW
UC
ZW
vh
vh
vh
ZW
ZW
ZW
ZW
ZW
cw
"}
(50,1,1) = {"
cw
cw
ZW
ZW
ZW
St
St
St
ZW
ZW
ZW
FF
FF
FF
ZW
UC
PW
PW
PW
PW
PW
PW
PW
UC
ZW
ZW
UC
PW
PW
PW
PW
PW
UC
ZW
FF
FF
FF
ZW
UC
UC
UC
UC
UC
UC
UC
UC
UC
UC
UC
UC
Eh
Eh
ZW
ZW
ZW
ZW
ZW
ZW
ZW
ZW
ZW
ZW
ZW
ZW
ZW
ZW
ZW
ZW
ZW
ZW
ZW
ZW
ZW
ZW
FF
FF
FF
ZW
UC
UC
UC
UC
UC
UC
UC
ZW
vh
vh
vh
ZW
ZW
ZW
ZW
ZW
cw
"}
(51,1,1) = {"
cw
cw
ZW
ZW
ZW
St
St
St
ZW
ZW
ZW
FF
FF
FF
ZW
UC
PW
PW
PW
PW
PW
PW
PW
UC
ZW
ZW
UC
PW
PW
PW
PW
PW
UC
ZW
FF
FF
FF
ZW
ZW
ZW
ZW
ZW
ZW
ZW
ZW
ZW
ZW
ZW
ZW
ZW
Eh
Eh
Eh
ZW
ZW
ZW
ZW
ZW
ZW
ZW
ZW
ZW
ZW
ZW
ZW
ZW
ZW
ZW
ZW
ZW
ZW
ZW
ZW
ZW
FF
FF
FF
ZW
ZW
ZW
ZW
ZW
ZW
ZW
ZW
ZW
vh
vh
vh
ZW
ZW
ZW
ZW
ZW
cw
"}
(52,1,1) = {"
cw
cw
ZW
ZW
ZW
vh
vh
St
ZW
ZW
ZW
FF
FF
FF
ZW
UC
PW
PW
PW
PW
PW
PW
PW
UC
ZW
ZW
UC
PW
PW
PW
PW
PW
UC
ZW
FF
FF
FF
ZW
UC
UC
UC
UC
UC
UC
UC
UC
ZW
ZW
Eh
Eh
Eh
Eh
Eh
Eh
ZW
ZW
ZW
ZW
ZW
ZW
ZW
ZW
ZW
ZW
ZW
ZW
ZW
ZW
ZW
ZW
ZW
ZW
ZW
ZW
FF
FF
FF
ZW
UC
UC
UC
UC
UC
UC
UC
ZW
vh
vh
vh
ZW
ZW
ZW
ZW
cw
cw
"}
(53,1,1) = {"
cw
cw
ZW
ZW
ZW
vh
vh
vh
ZW
ZW
ZW
FF
FF
FF
ZW
UC
PW
PW
PW
PW
PW
PW
PW
UC
ZW
ZW
UC
PW
PW
PW
PW
PW
UC
ZW
FF
FF
FF
ZW
UC
PW
PW
PW
PW
PW
PW
UC
ZW
Eh
Eh
Eh
ZW
ZW
ZW
Eh
Eh
Eh
ZW
ZW
ZW
ZW
ZW
ZW
ZW
ZW
ZW
ZW
ZW
ZW
ZW
ZW
ZW
ZW
ZW
ZW
FF
FF
FF
ZW
UC
PW
PW
PW
PW
PW
UC
ZW
vh
vh
vh
ZW
ZW
ZW
ZW
cw
cw
"}
(54,1,1) = {"
cw
cw
ZW
ZW
ZW
vh
vh
vh
ZW
ZW
ZW
FF
FF
FF
ZW
UC
PW
PW
PW
PW
PW
PW
PW
UC
ZW
ZW
UC
PW
PW
PW
PW
PW
UC
ZW
FF
FF
FF
ZW
UC
PW
PW
PW
PW
PW
PW
UC
ZW
Eh
Eh
ZW
ZW
ZW
ZW
ZW
Eh
Eh
UC
UC
UC
UC
UC
UC
UC
UC
UC
UC
UC
UC
UC
UC
UC
UC
UC
ZW
FF
FF
FF
ZW
UC
PW
PW
PW
PW
PW
UC
ZW
vh
vh
vh
ZW
ZW
ZW
ZW
cw
cw
"}
(55,1,1) = {"
cw
cw
ZW
ZW
ZW
vh
vh
vh
ZW
ZW
ZW
FF
FF
FF
ZW
UC
PW
PW
PW
PW
PW
PW
PW
UC
ZW
ZW
UC
PW
PW
PW
PW
PW
UC
ZW
FF
FF
FF
ZW
UC
PW
PW
PW
PW
PW
PW
UC
ZW
Eh
UC
UC
UC
UC
UC
UC
UC
Eh
UC
PW
PW
PW
PW
PW
PW
PW
PW
PW
PW
PW
PW
PW
PW
PW
UC
ZW
FF
FF
FF
ZW
UC
PW
PW
PW
PW
PW
UC
ZW
vh
vh
vh
ZW
ZW
ZW
ZW
cw
cw
"}
(56,1,1) = {"
cw
cw
ZW
ZW
ZW
vh
vh
vh
ZW
ZW
ZW
FF
FF
FF
ZW
UC
UC
UC
UC
UC
UC
UC
UC
UC
ZW
ZW
UC
UC
UC
UC
UC
UC
UC
ZW
FF
FF
FF
ZW
UC
PW
PW
PW
PW
PW
PW
UC
Eh
Eh
UC
PW
PW
PW
PW
PW
UC
Eh
UC
PW
PW
PW
PW
PW
PW
PW
PW
PW
PW
PW
PW
PW
PW
PW
UC
ZW
FF
FF
FF
ZW
UC
PW
PW
PW
PW
PW
UC
ZW
vh
vh
vh
ZW
ZW
ZW
ZW
cw
cw
"}
(57,1,1) = {"
cw
cw
ZW
ZW
ZW
vh
vh
vh
ZW
ZW
ZW
FF
FF
FF
ZW
ZW
ZW
ZW
ZW
ZW
ZW
ZW
ZW
ZW
ZW
ZW
ZW
ZW
ZW
ZW
ZW
ZW
ZW
ZW
FF
FF
FF
ZW
UC
PW
PW
PW
PW
PW
PW
UC
Eh
Eh
UC
PW
PW
PW
PW
PW
UC
Eh
UC
PW
PW
PW
PW
PW
PW
PW
PW
PW
PW
PW
PW
PW
PW
PW
UC
ZW
FF
FF
FF
ZW
UC
PW
PW
PW
PW
PW
UC
ZW
vh
vh
vh
ZW
ZW
ZW
ZW
cw
cw
"}
(58,1,1) = {"
cw
cw
ZW
ZW
ZW
vh
vh
vh
ZW
ZW
ZW
FF
FF
FF
FF
FF
FF
FF
FF
FF
FF
FF
FF
FF
FF
FF
FF
FF
FF
FF
FF
FF
FF
FF
FF
FF
FF
ZW
UC
PW
PW
PW
PW
PW
PW
UC
Eh
Eh
UC
PW
PW
PW
PW
PW
UC
Eh
UC
PW
PW
PW
PW
PW
PW
PW
PW
PW
PW
PW
PW
PW
PW
PW
UC
ZW
FF
FF
FF
ZW
UC
UC
UC
UC
UC
UC
UC
ZW
vh
vh
vh
ZW
ZW
ZW
ZW
cw
cw
"}
(59,1,1) = {"
cw
cw
ZW
ZW
ZW
vh
vh
vh
ZW
ZW
ZW
FF
FF
FF
FF
FF
FF
FF
FF
FF
FF
FF
FF
FF
FF
FF
FF
FF
FF
FF
FF
FF
FF
FF
FF
FF
FF
ZW
UC
PW
PW
PW
PW
PW
PW
UC
Eh
Eh
UC
PW
PW
PW
PW
PW
UC
Eh
UC
PW
PW
PW
PW
PW
PW
PW
PW
PW
PW
PW
PW
PW
PW
PW
UC
ZW
FF
FF
FF
ZW
ZW
ZW
ZW
ZW
ZW
ZW
ZW
ZW
vh
vh
vh
ZW
ZW
ZW
ZW
cw
cw
"}
(60,1,1) = {"
cw
cw
ZW
ZW
ZW
vh
vh
vh
ZW
ZW
ZW
FF
FF
FF
FF
FF
FF
FF
FF
FF
FF
FF
FF
FF
FF
FF
FF
FF
FF
FF
FF
FF
FF
FF
FF
FF
FF
ZW
UC
PW
PW
PW
PW
PW
PW
UC
Eh
Eh
UC
PW
PW
PW
PW
PW
UC
Eh
UC
PW
PW
PW
PW
PW
PW
PW
PW
PW
PW
PW
PW
PW
PW
PW
UC
ZW
FF
FF
FF
ZW
UC
UC
UC
UC
UC
UC
UC
ZW
vh
vh
vh
ZW
ZW
ZW
ZW
cw
cw
"}
(61,1,1) = {"
cw
cw
ZW
ZW
ZW
vh
vh
vh
ZW
ZW
ZW
ZW
ZW
ZW
ZW
ZW
ZW
ZW
ZW
ZW
ZW
ZW
ZW
ZW
ZW
ZW
ZW
ZW
ZW
ZW
ZW
ZW
ZW
ZW
FF
FF
FF
ZW
UC
PW
PW
PW
PW
PW
PW
UC
Eh
Eh
UC
PW
PW
PW
PW
PW
UC
Eh
UC
PW
PW
PW
PW
PW
PW
PW
PW
PW
PW
PW
PW
PW
PW
PW
UC
ZW
FF
FF
FF
ZW
UC
PW
PW
PW
PW
PW
UC
ZW
vh
vh
vh
ZW
ZW
ZW
ZW
cw
cw
"}
(62,1,1) = {"
cw
cw
ZW
ZW
ZW
vh
vh
vh
ZW
ZW
ZW
UC
UC
UC
UC
UC
UC
UC
UC
UC
UC
UC
UC
UC
UC
ZW
UC
UC
UC
UC
UC
UC
UC
ZW
FF
FF
FF
ZW
UC
PW
PW
PW
PW
PW
PW
UC
Eh
Eh
UC
PW
PW
PW
PW
PW
UC
Eh
UC
PW
PW
PW
PW
PW
PW
PW
PW
PW
PW
PW
PW
PW
PW
PW
UC
ZW
FF
FF
FF
ZW
UC
PW
PW
PW
PW
PW
UC
ZW
vh
vh
vh
ZW
ZW
ZW
ZW
cw
cw
"}
(63,1,1) = {"
cw
cw
ZW
ZW
ZW
vh
vh
vh
ZW
ZW
ZW
UC
PW
PW
PW
PW
PW
PW
PW
PW
PW
PW
PW
PW
UC
ZW
UC
PW
PW
PW
PW
PW
UC
ZW
FF
FF
FF
ZW
UC
UC
UC
UC
UC
UC
UC
UC
Eh
Eh
UC
UC
UC
UC
UC
UC
UC
Eh
UC
UC
UC
UC
UC
UC
UC
UC
UC
UC
UC
UC
UC
UC
UC
UC
UC
ZW
FF
FF
FF
ZW
UC
PW
PW
PW
PW
PW
UC
ZW
St
vh
St
ZW
ZW
ZW
ZW
cw
cw
"}
(64,1,1) = {"
cw
cw
ZW
ZW
ZW
vh
vh
vh
ZW
ZW
ZW
UC
PW
PW
PW
PW
PW
PW
PW
PW
PW
PW
PW
PW
UC
ZW
UC
PW
PW
PW
PW
PW
UC
ZW
FF
FF
FF
ZW
ZW
ZW
ZW
ZW
ZW
ZW
ZW
ZW
Eh
Eh
ZW
ZW
ZW
ZW
ZW
ZW
Eh
Eh
Eh
ZW
ZW
ZW
ZW
ZW
ZW
ZW
ZW
ZW
ZW
ZW
ZW
ZW
ZW
ZW
ZW
ZW
FF
FF
FF
ZW
UC
PW
PW
PW
PW
PW
UC
ZW
St
St
St
ZW
ZW
ZW
ZW
ZW
cw
"}
(65,1,1) = {"
cw
cw
ZW
ZW
ZW
vh
vh
vh
ZW
ZW
ZW
UC
PW
PW
PW
PW
PW
PW
PW
PW
PW
PW
PW
PW
UC
ZW
UC
PW
PW
PW
PW
PW
UC
ZW
FF
FF
FF
FF
FF
FF
FF
FF
FF
FF
FF
FF
FF
FF
FF
FF
FF
FF
FF
FF
FF
FF
FF
FF
FF
FF
FF
FF
FF
FF
FF
FF
FF
FF
FF
FF
FF
FF
FF
FF
FF
FF
FF
ZW
UC
PW
PW
PW
PW
PW
UC
ZW
St
St
St
ZW
ZW
ZW
ZW
ZW
cw
"}
(66,1,1) = {"
cw
cw
ZW
ZW
ZW
vh
vh
vh
ZW
ZW
ZW
UC
PW
PW
PW
PW
PW
PW
PW
PW
PW
PW
PW
PW
UC
ZW
UC
PW
PW
PW
PW
PW
UC
ZW
FF
FF
FF
FF
FF
FF
FF
FF
FF
FF
FF
FF
FF
FF
FF
FF
FF
FF
FF
FF
FF
FF
FF
FF
FF
FF
FF
FF
FF
FF
FF
FF
FF
FF
FF
FF
FF
FF
FF
FF
FF
FF
FF
ZW
UC
PW
PW
PW
PW
PW
UC
ZW
St
St
St
ZW
ZW
ZW
ZW
ZW
cw
"}
(67,1,1) = {"
cw
cw
ZW
ZW
ZW
vh
vh
vh
ZW
ZW
ZW
UC
PW
PW
PW
PW
PW
PW
PW
PW
PW
PW
PW
PW
UC
ZW
UC
PW
PW
PW
PW
PW
UC
ZW
FF
FF
FF
FF
FF
FF
FF
FF
FF
FF
FF
FF
FF
FF
FF
FF
FF
FF
FF
FF
FF
FF
FF
FF
FF
FF
FF
FF
FF
FF
FF
FF
FF
FF
FF
FF
FF
FF
FF
FF
FF
FF
FF
ZW
UC
PW
PW
PW
PW
PW
UC
ZW
vh
St
St
ZW
ZW
ZW
ZW
ZW
cw
"}
(68,1,1) = {"
cw
cw
ZW
ZW
ZW
vh
vh
vh
ZW
ZW
ZW
UC
PW
PW
PW
PW
PW
PW
PW
PW
PW
PW
PW
PW
UC
ZW
UC
PW
PW
PW
PW
PW
UC
ZW
FF
FF
FF
ZW
ZW
ZW
ZW
ZW
ZW
ZW
ZW
ZW
ZW
ZW
ZW
ZW
ZW
ZW
ZW
ZW
ZW
ZW
ZW
ZW
ZW
ZW
ZW
ZW
ZW
ZW
ZW
ZW
ZW
ZW
ZW
ZW
ZW
ZW
ZW
ZW
ZW
ZW
ZW
ZW
UC
PW
PW
PW
PW
PW
UC
ZW
vh
vh
vh
ZW
ZW
ZW
ZW
ZW
cw
"}
(69,1,1) = {"
cw
cw
ZW
ZW
ZW
vh
vh
vh
ZW
ZW
ZW
UC
UC
UC
UC
UC
UC
UC
UC
UC
UC
UC
UC
UC
UC
ZW
UC
PW
PW
PW
PW
PW
UC
ZW
FF
FF
FF
ZW
ZW
ZW
ZW
ZW
ZW
ZW
ZW
ZW
ZW
ZW
ZW
ZW
ZW
ZW
ZW
ZW
ZW
ZW
ZW
ZW
ZW
ZW
ZW
ZW
ZW
ZW
ZW
ZW
ZW
ZW
ZW
ZW
ZW
ZW
ZW
ZW
ZW
ZW
ZW
ZW
UC
UC
UC
UC
UC
UC
UC
ZW
vh
vh
vh
ZW
ZW
ZW
ZW
ZW
cw
"}
(70,1,1) = {"
cw
ZW
ZW
ZW
ZW
vh
vh
vh
ZW
ZW
ZW
ZW
ZW
ZW
ZW
ZW
ZW
ZW
ZW
ZW
ZW
ZW
ZW
ZW
ZW
ZW
UC
UC
UC
UC
UC
UC
UC
ZW
FF
FF
FF
ZW
ZW
ZW
ZW
ZW
ZW
ZW
ZW
ZW
ZW
ZW
ZW
ZW
ZW
ZW
ZW
ZW
ZW
ZW
ZW
ZW
ZW
ZW
ZW
ZW
ZW
ZW
ZW
ZW
ZW
ZW
ZW
ZW
ZW
ZW
ZW
ZW
ZW
ZW
ZW
ZW
ZW
ZW
ZW
ZW
ZW
ZW
ZW
ZW
vh
vh
vh
ZW
ZW
ZW
ZW
ZW
cw
"}
(71,1,1) = {"
cw
ZW
ZW
ZW
ZW
vh
vh
vh
ZW
ZW
ZW
ZW
ZW
ZW
ZW
ZW
ZW
ZW
ZW
ZW
ZW
ZW
ZW
ZW
ZW
ZW
ZW
ZW
ZW
ZW
ZW
ZW
ZW
ZW
FF
FF
FF
ZW
ZW
ZW
ZW
ZW
ZW
ZW
ZW
ZW
ZW
ZW
ZW
ZW
ZW
ZW
ZW
ZW
ZW
ZW
ZW
ZW
ZW
ZW
ZW
ZW
ZW
ZW
ZW
ZW
ZW
ZW
ZW
ZW
ZW
ZW
ZW
ZW
ZW
ZW
ZW
ZW
ZW
ZW
ZW
ZW
ZW
ZW
ZW
ZW
vh
vh
vh
ZW
ZW
ZW
ZW
ZW
cw
"}
(72,1,1) = {"
cw
ZW
ZW
ZW
ZW
vh
vh
vh
vh
vh
vh
vh
vh
vh
vh
vh
vh
vh
vh
vh
vh
vh
vh
vh
vh
vh
vh
vh
vh
vh
vh
zg
zg
ZW
FF
FF
FF
ZW
zg
zg
vh
vh
vh
vh
vh
vh
vh
vh
vh
vh
vh
vh
St
St
St
vh
vh
vh
vh
vh
vh
vh
vh
vh
vh
vh
vh
vh
vh
vh
vh
vh
vh
vh
vh
vh
vh
vh
vh
vh
vh
vh
vh
vh
vh
vh
vh
vh
vh
ZW
ZW
ZW
ZW
ZW
cw
"}
(73,1,1) = {"
cw
cw
ZW
ZW
ZW
vh
vh
vh
vh
vh
vh
vh
vh
vh
vh
vh
vh
vh
vh
vh
vh
vh
vh
vh
vh
vh
vh
vh
vh
vh
vh
vh
zg
ZW
FF
FF
FF
ZW
zg
vh
vh
vh
vh
vh
vh
vh
vh
vh
vh
vh
vh
St
St
St
St
St
St
vh
vh
vh
vh
vh
vh
vh
vh
vh
vh
vh
vh
vh
vh
vh
vh
vh
vh
vh
vh
vh
vh
vh
vh
vh
vh
vh
vh
vh
vh
vh
vh
ZW
ZW
ZW
ZW
ZW
cw
"}
(74,1,1) = {"
cw
cw
ZW
ZW
ZW
vh
vh
vh
vh
vh
vh
vh
vh
vh
vh
vh
vh
vh
vh
vh
vh
vh
vh
vh
vh
vh
vh
vh
vh
vh
vh
zg
zg
ZW
FF
FF
FF
ZW
zg
zg
vh
vh
vh
vh
vh
vh
vh
vh
vh
vh
St
St
St
St
St
St
St
St
St
vh
vh
vh
vh
vh
vh
vh
vh
vh
vh
vh
vh
vh
vh
vh
vh
vh
vh
vh
vh
vh
vh
vh
vh
vh
vh
vh
vh
vh
vh
ZW
ZW
ZW
ZW
cw
cw
"}
(75,1,1) = {"
cw
cw
ZW
ZW
ZW
ZW
ZW
ZW
ZW
ZW
ZW
ZW
ZW
ZW
ZW
ZW
ZW
ZW
ZW
ZW
ZW
ZW
ZW
ZW
ZW
ZW
ZW
ZW
ZW
ZW
ZW
ZW
ZW
ZW
FF
FF
FF
ZW
ZW
ZW
ZW
ZW
ZW
ZW
ZW
ZW
ZW
ZW
ZW
ZW
ZW
ZW
ZW
ZW
ZW
ZW
ZW
ZW
ZW
ZW
ZW
ZW
ZW
ZW
ZW
ZW
ZW
ZW
ZW
ZW
ZW
ZW
ZW
ZW
ZW
ZW
ZW
ZW
ZW
ZW
ZW
ZW
ZW
ZW
ZW
ZW
ZW
ZW
ZW
ZW
ZW
ZW
ZW
cw
cw
"}
(76,1,1) = {"
cw
cw
ZW
ZW
ZW
ZW
ZW
ZW
ZW
ZW
ZW
ZW
ZW
ZW
ZW
ZW
ZW
ZW
ZW
ZW
ZW
ZW
ZW
ZW
ZW
ZW
ZW
ZW
ZW
ZW
ZW
ZW
ZW
ZW
FF
FF
FF
ZW
ZW
ZW
ZW
ZW
ZW
ZW
ZW
ZW
ZW
ZW
ZW
ZW
ZW
ZW
ZW
ZW
ZW
ZW
ZW
ZW
ZW
ZW
ZW
ZW
ZW
ZW
ZW
ZW
ZW
ZW
ZW
ZW
ZW
ZW
ZW
ZW
ZW
ZW
ZW
ZW
ZW
ZW
ZW
ZW
ZW
ZW
ZW
ZW
ZW
ZW
ZW
ZW
ZW
ZW
ZW
cw
cw
"}
(77,1,1) = {"
cw
cw
ZW
ZW
ZW
ZW
ZW
ZW
ZW
ZW
ZW
ZW
ZW
ZW
ZW
ZW
ZW
ZW
ZW
ZW
ZW
ZW
ZW
ZW
ZW
ZW
ZW
ZW
ZW
ZW
ZW
ZW
ZW
ZW
FF
FF
FF
ZW
ZW
ZW
ZW
ZW
ZW
ZW
ZW
ZW
ZW
ZW
ZW
ZW
ZW
ZW
ZW
ZW
ZW
ZW
ZW
ZW
ZW
ZW
ZW
ZW
ZW
ZW
ZW
ZW
ZW
ZW
ZW
ZW
ZW
ZW
ZW
ZW
ZW
ZW
ZW
ZW
ZW
ZW
ZW
ZW
ZW
ZW
ZW
ZW
ZW
ZW
ZW
ZW
ZW
ZW
ZW
cw
cw
"}
(78,1,1) = {"
cw
cw
ZW
ZW
ZW
ZW
ZW
ZW
ZW
ZW
ZW
ZW
ZW
ZW
ZW
ZW
ZW
ZW
ZW
ZW
ZW
ZW
ZW
ZW
ZW
ZW
ZW
ZW
ZW
ZW
ZW
ZW
ZW
ZW
FF
FF
FF
ZW
ZW
ZW
ZW
ZW
ZW
ZW
ZW
ZW
ZW
ZW
ZW
ZW
ZW
ZW
ZW
ZW
ZW
ZW
ZW
ZW
ZW
ZW
ZW
ZW
ZW
ZW
ZW
ZW
ZW
ZW
ZW
ZW
ZW
ZW
ZW
ZW
ZW
ZW
ZW
ZW
ZW
ZW
ZW
ZW
ZW
ZW
ZW
ZW
ZW
ZW
ZW
ZW
ZW
ZW
ZW
cw
cw
"}
(79,1,1) = {"
cw
cw
ZW
ZW
ZW
ZW
ZW
ZW
ZW
ZW
ZW
ZW
ZW
ZW
ZW
ZW
ZW
ZW
ZW
ZW
ZW
ZW
ZW
ZW
ZW
ZW
ZW
ZW
ZW
ZW
ZW
ZW
ZW
ZW
FF
FF
FF
ZW
ZW
ZW
ZW
ZW
ZW
ZW
ZW
ZW
ZW
ZW
ZW
ZW
ZW
ZW
ZW
ZW
ZW
ZW
ZW
ZW
ZW
ZW
ZW
ZW
ZW
ZW
ZW
ZW
ZW
ZW
ZW
ZW
ZW
ZW
ZW
ZW
ZW
ZW
ZW
ZW
ZW
ZW
ZW
ZW
ZW
ZW
ZW
ZW
ZW
ZW
ZW
ZW
ZW
ZW
ZW
ZW
cw
"}
(80,1,1) = {"
cw
cw
ZW
ZW
ZW
ZW
ZW
ZW
ZW
ZW
ZW
ZW
ZW
ZW
ZW
ZW
ZW
ZW
ZW
ZW
ZW
ZW
ZW
ZW
ZW
ZW
ZW
ZW
ZW
ZW
ZW
ZW
ZW
ZW
FF
FF
FF
ZW
ZW
ZW
ZW
ZW
ZW
ZW
ZW
ZW
ZW
ZW
ZW
ZW
ZW
ZW
ZW
ZW
ZW
ZW
ZW
ZW
ZW
ZW
ZW
ZW
ZW
ZW
ZW
ZW
ZW
ZW
ZW
ZW
ZW
ZW
ZW
ZW
ZW
ZW
ZW
ZW
ZW
ZW
ZW
ZW
ZW
ZW
ZW
ZW
ZW
ZW
ZW
ZW
ZW
ZW
ZW
ZW
cw
"}
(81,1,1) = {"
cw
cw
ZW
ZW
ZW
ZW
ZW
ZW
ZW
ZW
ZW
ZW
ZW
ZW
ZW
ZW
ZW
ZW
ZW
ZW
ZW
ZW
ZW
ZW
ZW
ZW
ZW
ZW
ZW
ZW
ZW
ZW
ZW
ZW
FF
FF
FF
ZW
ZW
ZW
ZW
ZW
ZW
ZW
ZW
ZW
ZW
ZW
ZW
ZW
ZW
ZW
ZW
ZW
ZW
ZW
ZW
ZW
ZW
ZW
ZW
ZW
ZW
ZW
ZW
ZW
ZW
ZW
ZW
ZW
ZW
ZW
ZW
ZW
ZW
ZW
ZW
ZW
ZW
ZW
ZW
ZW
ZW
ZW
ZW
ZW
ZW
ZW
ZW
ZW
ZW
ZW
ZW
ZW
cw
"}
(82,1,1) = {"
cw
cw
ZW
ZW
ZW
ZW
ZW
ZW
ZW
ZW
ZW
ZW
ZW
ZW
ZW
ZW
ZW
ZW
ZW
ZW
ZW
ZW
ZW
ZW
ZW
ZW
ZW
ZW
ZW
ZW
ZW
ZW
ZW
ZW
FF
FF
FF
ZW
ZW
ZW
ZW
ZW
ZW
ZW
ZW
ZW
ZW
ZW
ZW
ZW
ZW
ZW
ZW
ZW
ZW
ZW
ZW
ZW
ZW
ZW
ZW
ZW
ZW
ZW
ZW
ZW
ZW
ZW
ZW
ZW
ZW
ZW
ZW
ZW
ZW
ZW
ZW
ZW
ZW
ZW
ZW
ZW
ZW
ZW
ZW
ZW
ZW
ZW
ZW
ZW
ZW
ZW
ZW
ZW
cw
"}
(83,1,1) = {"
cw
cw
ZW
ZW
ZW
ZW
ZW
ZW
ZW
ZW
ZW
ZW
ZW
ZW
ZW
ZW
ZW
ZW
ZW
ZW
ZW
ZW
ZW
ZW
ZW
ZW
ZW
ZW
ZW
ZW
ZW
ZW
ZW
ZW
FF
FF
FF
ZW
ZW
ZW
ZW
ZW
ZW
ZW
ZW
ZW
ZW
ZW
ZW
ZW
ZW
ZW
ZW
ZW
ZW
ZW
ZW
ZW
ZW
ZW
ZW
ZW
ZW
ZW
ZW
ZW
ZW
ZW
ZW
ZW
ZW
ZW
ZW
ZW
ZW
ZW
ZW
ZW
ZW
ZW
ZW
ZW
ZW
ZW
ZW
ZW
ZW
ZW
ZW
ZW
ZW
ZW
cw
cw
cw
"}
(84,1,1) = {"
cw
cw
ZW
ZW
ZW
ZW
ZW
ZW
ZW
ZW
ZW
ZW
ZW
ZW
ZW
ZW
ZW
ZW
ZW
ZW
ZW
ZW
ZW
ZW
ZW
ZW
ZW
ZW
ZW
ZW
ZW
ZW
ZW
ZW
FF
FF
FF
ZW
ZW
ZW
ZW
ZW
ZW
ZW
ZW
ZW
ZW
ZW
ZW
ZW
ZW
ZW
ZW
ZW
ZW
ZW
ZW
ZW
ZW
ZW
ZW
ZW
ZW
ZW
ZW
ZW
ZW
ZW
ZW
ZW
ZW
ZW
ZW
ZW
ZW
ZW
ZW
ZW
ZW
ZW
ZW
ZW
ZW
ZW
ZW
ZW
ZW
ZW
ZW
ZW
ZW
ZW
ZW
cw
cw
"}
(85,1,1) = {"
cw
cw
ZW
ZW
ZW
ZW
ZW
ZW
ZW
ZW
ZW
ZW
ZW
ZW
ZW
ZW
ZW
ZW
ZW
ZW
ZW
ZW
ZW
ZW
ZW
ZW
ZW
ZW
ZW
ZW
ZW
ZW
ZW
ZW
FF
FF
FF
ZW
ZW
ZW
ZW
ZW
ZW
ZW
ZW
ZW
ZW
ZW
ZW
ZW
ZW
ZW
ZW
ZW
ZW
ZW
ZW
ZW
ZW
ZW
ZW
ZW
ZW
ZW
ZW
ZW
ZW
ZW
ZW
ZW
ZW
ZW
ZW
ZW
ZW
ZW
ZW
ZW
ZW
ZW
ZW
ZW
ZW
ZW
ZW
ZW
ZW
ZW
ZW
ZW
ZW
ZW
ZW
cw
cw
"}
(86,1,1) = {"
cw
cw
ZW
ZW
ZW
ZW
ZW
ZW
ZW
ZW
ZW
ZW
ZW
ZW
ZW
ZW
ZW
ZW
ZW
ZW
ZW
ZW
ZW
ZW
ZW
ZW
ZW
ZW
ZW
ZW
ZW
ZW
ZW
ZW
FF
FF
FF
ZW
ZW
ZW
ZW
ZW
ZW
ZW
ZW
ZW
ZW
ZW
ZW
ZW
ZW
ZW
ZW
ZW
ZW
ZW
ZW
ZW
ZW
ZW
ZW
ZW
ZW
ZW
ZW
ZW
ZW
ZW
ZW
ZW
ZW
ZW
ZW
ZW
ZW
ZW
ZW
ZW
ZW
ZW
ZW
ZW
ZW
ZW
ZW
ZW
ZW
ZW
ZW
ZW
ZW
ZW
ZW
cw
cw
"}
(87,1,1) = {"
cw
cw
ZW
ZW
ZW
ZW
ZW
ZW
ZW
ZW
ZW
ZW
ZW
ZW
ZW
ZW
ZW
ZW
ZW
ZW
ZW
ZW
ZW
ZW
ZW
ZW
ZW
ZW
ZW
ZW
ZW
ZW
ZW
ZW
FF
FF
FF
ZW
ZW
ZW
ZW
ZW
ZW
ZW
ZW
ZW
ZW
ZW
ZW
ZW
ZW
ZW
ZW
ZW
ZW
ZW
ZW
ZW
ZW
ZW
ZW
ZW
ZW
ZW
ZW
ZW
ZW
ZW
ZW
ZW
ZW
ZW
ZW
ZW
ZW
ZW
ZW
ZW
ZW
ZW
ZW
ZW
ZW
ZW
ZW
ZW
ZW
ZW
ZW
ZW
ZW
ZW
ZW
cw
cw
"}
(88,1,1) = {"
cw
cw
ZW
ZW
ZW
ZW
ZW
ZW
ZW
ZW
ZW
ZW
ZW
ZW
ZW
ZW
ZW
ZW
ZW
ZW
ZW
ZW
ZW
ZW
ZW
ZW
ZW
ZW
ZW
ZW
ZW
ZW
ZW
ZW
FF
FF
FF
ZW
ZW
ZW
ZW
ZW
ZW
ZW
ZW
ZW
ZW
ZW
ZW
ZW
ZW
ZW
ZW
ZW
ZW
ZW
ZW
ZW
ZW
ZW
ZW
ZW
ZW
ZW
ZW
ZW
ZW
ZW
ZW
ZW
ZW
ZW
ZW
ZW
ZW
ZW
ZW
ZW
ZW
ZW
ZW
ZW
ZW
ZW
ZW
ZW
ZW
ZW
ZW
ZW
ZW
ZW
ZW
cw
cw
"}
(89,1,1) = {"
cw
cw
ZW
ZW
ZW
ZW
ZW
ZW
ZW
ZW
ZW
ZW
ZW
ZW
ZW
ZW
ZW
ZW
ZW
ZW
ZW
ZW
ZW
ZW
ZW
ZW
ZW
ZW
ZW
ZW
ZW
ZW
ZW
ZW
FF
FF
FF
ZW
ZW
ZW
ZW
ZW
ZW
ZW
ZW
ZW
ZW
ZW
ZW
ZW
ZW
ZW
ZW
ZW
ZW
ZW
ZW
ZW
ZW
ZW
ZW
ZW
ZW
ZW
ZW
ZW
ZW
ZW
ZW
ZW
ZW
ZW
ZW
ZW
ZW
ZW
ZW
ZW
ZW
ZW
ZW
ZW
ZW
ZW
ZW
ZW
ZW
ZW
ZW
ZW
ZW
ZW
ZW
cw
cw
"}
(90,1,1) = {"
cw
cw
ZW
ZW
ZW
ZW
ZW
ZW
ZW
ZW
ZW
ZW
ZW
ZW
ZW
ZW
ZW
ZW
ZW
ZW
ZW
ZW
ZW
ZW
ZW
ZW
ZW
ZW
ZW
ZW
ZW
ZW
ZW
ZW
FF
FF
FF
ZW
ZW
ZW
ZW
ZW
ZW
ZW
ZW
ZW
ZW
ZW
ZW
ZW
ZW
ZW
ZW
ZW
ZW
ZW
ZW
ZW
ZW
ZW
ZW
ZW
ZW
ZW
ZW
ZW
ZW
ZW
ZW
ZW
ZW
ZW
ZW
ZW
ZW
ZW
ZW
ZW
ZW
ZW
ZW
ZW
ZW
ZW
ZW
ZW
ZW
ZW
ZW
ZW
ZW
ZW
ZW
ZW
cw
"}
(91,1,1) = {"
cw
cw
ZW
ZW
ZW
ZW
ZW
ZW
ZW
ZW
ZW
ZW
ZW
ZW
ZW
ZW
ZW
ZW
ZW
ZW
ZW
ZW
ZW
ZW
ZW
ZW
ZW
ZW
ZW
ZW
ZW
ZW
ZW
ZW
FF
FF
FF
ZW
ZW
ZW
ZW
ZW
ZW
ZW
ZW
ZW
ZW
ZW
ZW
ZW
ZW
ZW
ZW
ZW
ZW
ZW
ZW
ZW
ZW
ZW
ZW
ZW
ZW
ZW
ZW
ZW
ZW
ZW
ZW
ZW
ZW
ZW
ZW
ZW
ZW
ZW
ZW
ZW
ZW
ZW
ZW
ZW
ZW
ZW
ZW
ZW
ZW
ZW
ZW
ZW
ZW
ZW
ZW
cw
cw
"}
(92,1,1) = {"
cw
cw
ZW
ZW
ZW
ZW
ZW
ZW
ZW
ZW
ZW
ZW
ZW
ZW
ZW
ZW
ZW
ZW
ZW
ZW
ZW
ZW
ZW
ZW
ZW
ZW
ZW
ZW
ZW
ZW
ZW
ZW
ZW
ZW
FF
FF
FF
ZW
ZW
ZW
ZW
ZW
ZW
ZW
ZW
ZW
ZW
ZW
ZW
ZW
ZW
ZW
ZW
ZW
ZW
ZW
ZW
ZW
ZW
ZW
ZW
ZW
ZW
ZW
ZW
ZW
ZW
ZW
ZW
ZW
ZW
ZW
ZW
ZW
ZW
ZW
ZW
ZW
ZW
ZW
ZW
ZW
ZW
ZW
ZW
ZW
ZW
ZW
ZW
ZW
ZW
ZW
cw
cw
cw
"}
(93,1,1) = {"
cw
cw
cw
ZW
ZW
ZW
ZW
ZW
ZW
ZW
ZW
ZW
ZW
ZW
ZW
ZW
ZW
ZW
ZW
ZW
ZW
ZW
ZW
ZW
ZW
ZW
ZW
ZW
ZW
ZW
ZW
ZW
ZW
ZW
FF
FF
FF
ZW
ZW
ZW
ZW
ZW
ZW
ZW
ZW
ZW
ZW
ZW
ZW
ZW
ZW
ZW
ZW
ZW
ZW
ZW
ZW
ZW
ZW
ZW
ZW
ZW
ZW
ZW
ZW
ZW
ZW
ZW
ZW
ZW
ZW
cw
cw
ZW
ZW
ZW
ZW
ZW
ZW
ZW
ZW
ZW
ZW
ZW
ZW
ZW
ZW
ZW
ZW
ZW
ZW
ZW
cw
cw
cw
"}
(94,1,1) = {"
cw
cw
cw
cw
cw
cw
cw
ZW
ZW
ZW
ZW
ZW
ZW
ZW
ZW
ZW
ZW
cw
cw
cw
cw
cw
cw
cw
cw
cw
cw
ZW
ZW
ZW
ZW
ZW
ZW
ZW
FF
FF
FF
ZW
ZW
ZW
ZW
ZW
ZW
cw
cw
cw
cw
cw
cw
cw
cw
cw
ZW
ZW
ZW
ZW
ZW
ZW
ZW
cw
cw
cw
ZW
ZW
ZW
ZW
ZW
ZW
cw
cw
cw
cw
cw
cw
cw
cw
ZW
ZW
ZW
ZW
ZW
ZW
ZW
ZW
ZW
ZW
ZW
cw
cw
cw
cw
cw
cw
cw
cw
"}
(95,1,1) = {"
cw
cw
cw
cw
cw
cw
cw
cw
cw
cw
cw
cw
cw
cw
cw
cw
cw
cw
cw
cw
cw
cw
cw
cw
cw
cw
cw
cw
cw
cw
cw
cw
cw
cw
cw
cw
cw
cw
cw
cw
cw
cw
cw
cw
cw
cw
cw
cw
cw
cw
cw
cw
cw
cw
cw
cw
cw
cw
cw
cw
cw
cw
cw
cw
cw
cw
cw
cw
cw
cw
cw
cw
cw
cw
cw
cw
cw
cw
cw
cw
cw
cw
cw
cw
cw
cw
cw
cw
cw
cw
cw
cw
cw
cw
cw
"}
