//MAP CONVERTED BY dmm2tgm.py THIS HEADER COMMENT PREVENTS RECONVERSION, DO NOT REMOVE
"aM" = (
/obj/machinery/firealarm/directional/west,
/turf/open/floor/iron/dark,
/area/shuttle/ruin/caravan/syndicate3)
"bV" = (
/obj/structure/chair/comfy/shuttle,
/obj/machinery/light/small/directional/west,
/obj/machinery/power/apc/syndicate{
	dir = 8;
	name = "Syndicate Drop Ship APC";
	pixel_x = -25
	},
/obj/effect/decal/cleanable/dirt,
/obj/structure/cable,
/turf/open/floor/pod/dark,
/area/shuttle/ruin/caravan/syndicate3)
"db" = (
/obj/machinery/computer/crew{
	dir = 8
	},
/obj/effect/decal/cleanable/dirt,
/obj/effect/turf_decal/tile/red{
	dir = 1
	},
/obj/effect/turf_decal/tile/red{
	dir = 4
	},
/obj/effect/turf_decal/tile/red{
	dir = 8
	},
/turf/open/floor/iron/dark,
/area/shuttle/ruin/caravan/syndicate3)
"fh" = (
/obj/machinery/power/shuttle_engine/propulsion/burst/right{
	dir = 8
	},
/turf/open/floor/plating/airless,
/area/shuttle/ruin/caravan/syndicate3)
"fK" = (
/obj/effect/turf_decal/stripes/line{
	dir = 8
	},
/obj/structure/sign/warning/vacuum/directional/south,
/obj/effect/decal/cleanable/dirt,
/obj/structure/closet/syndicate{
	anchored = 1
	},
/obj/item/clothing/under/syndicate/combat,
/obj/item/storage/belt/military,
/turf/open/floor/mineral/plastitanium,
/area/shuttle/ruin/caravan/syndicate3)
"ge" = (
/obj/structure/chair/comfy/shuttle,
/obj/machinery/airalarm/syndicate{
	dir = 1;
	pixel_y = 24
	},
/obj/effect/decal/cleanable/dirt,
/turf/open/floor/pod/dark,
/area/shuttle/ruin/caravan/syndicate3)
"gj" = (
/obj/structure/chair/comfy/shuttle{
	dir = 1
	},
/obj/effect/decal/cleanable/dirt,
/turf/open/floor/pod/dark,
/area/shuttle/ruin/caravan/syndicate3)
"gm" = (
/obj/effect/turf_decal/stripes/line{
	dir = 8
	},
/obj/machinery/light/small/directional/east,
/obj/effect/decal/cleanable/dirt,
/obj/effect/decal/cleanable/dirt,
/obj/structure/closet/syndicate{
	anchored = 1
	},
/obj/item/storage/box/syndie_kit/chameleon,
/obj/item/crowbar/red,
/turf/open/floor/mineral/plastitanium,
/area/shuttle/ruin/caravan/syndicate3)
"hR" = (
/obj/machinery/door/airlock/hatch{
	id_tag = "caravansyndicate3_bolt_port";
	name = "External Airlock";
	normalspeed = 0
	},
/obj/docking_port/mobile{
	dir = 2;
	shuttle_id = "caravansyndicate3";
	name = "Syndicate Drop Ship";
	port_direction = 8;
	preferred_direction = 4
	},
/obj/effect/mapping_helpers/airlock/cyclelink_helper,
/obj/effect/mapping_helpers/airlock/access/all/syndicate/general,
/turf/open/floor/plating,
/area/shuttle/ruin/caravan/syndicate3)
"ix" = (
/obj/structure/table/reinforced,
/obj/item/storage/toolbox/emergency,
/obj/item/wrench,
/obj/machinery/light/small/directional/west,
/obj/effect/decal/cleanable/dirt,
/obj/effect/decal/cleanable/dirt,
/obj/effect/turf_decal/tile/red{
	dir = 1
	},
/obj/effect/turf_decal/tile/red{
	dir = 4
	},
/obj/effect/turf_decal/tile/red{
	dir = 8
	},
/turf/open/floor/iron/dark,
/area/shuttle/ruin/caravan/syndicate3)
"jh" = (
/turf/open/floor/iron/dark,
/area/shuttle/ruin/caravan/syndicate3)
"ko" = (
/turf/closed/wall/mineral/plastitanium,
/area/shuttle/ruin/caravan/syndicate3)
"lC" = (
/obj/effect/turf_decal/tile/red{
	dir = 1
	},
/obj/effect/turf_decal/tile/red{
	dir = 4
	},
/turf/open/floor/iron/dark,
/area/shuttle/ruin/caravan/syndicate3)
"lX" = (
/obj/structure/table/reinforced,
/obj/machinery/recharger,
/obj/machinery/light/small/directional/west,
/obj/effect/turf_decal/tile/red{
	dir = 1
	},
/obj/effect/turf_decal/tile/red,
/obj/effect/turf_decal/tile/red{
	dir = 8
	},
/turf/open/floor/iron/dark,
/area/shuttle/ruin/caravan/syndicate3)
"mn" = (
/obj/effect/turf_decal/stripes/line{
	dir = 10
	},
/obj/structure/closet/syndicate{
	anchored = 1
	},
/obj/item/clothing/under/syndicate/combat,
/turf/open/floor/mineral/plastitanium,
/area/shuttle/ruin/caravan/syndicate3)
"nP" = (
/obj/machinery/door/airlock/hatch{
	id_tag = "caravansyndicate3_bolt_starboard";
	name = "External Airlock";
	normalspeed = 0
	},
/obj/effect/mapping_helpers/airlock/cyclelink_helper{
	dir = 1
	},
/obj/effect/mapping_helpers/airlock/access/all/syndicate/general,
/turf/open/floor/plating,
/area/shuttle/ruin/caravan/syndicate3)
"nX" = (
/obj/structure/chair/comfy/shuttle{
	dir = 1
	},
/obj/machinery/light/small/directional/west,
/obj/effect/decal/cleanable/dirt,
/turf/open/floor/pod/dark,
/area/shuttle/ruin/caravan/syndicate3)
"ow" = (
/obj/machinery/firealarm/directional/west,
/obj/effect/decal/cleanable/dirt,
/turf/open/floor/iron/dark,
/area/shuttle/ruin/caravan/syndicate3)
"pM" = (
/obj/effect/turf_decal/stripes/line{
	dir = 10
	},
/obj/effect/decal/cleanable/dirt,
/obj/structure/closet/syndicate{
	anchored = 1
	},
/obj/item/clothing/under/syndicate/combat,
/obj/item/clothing/shoes/jackboots,
/obj/item/storage/belt/military,
/obj/item/crowbar/red,
/turf/open/floor/mineral/plastitanium,
/area/shuttle/ruin/caravan/syndicate3)
"rX" = (
/obj/machinery/turretid{
	ailock = 1;
	desc = "A specially designed set of turret controls. Looks to be covered in protective casing to prevent AI interfacing.";
	icon_state = "control_kill";
	lethal = 1;
	name = "Shuttle turret control";
	pixel_y = 34;
	req_access = list("syndicate")
	},
/obj/structure/chair/comfy/shuttle{
	dir = 4
	},
/obj/effect/turf_decal/tile/red{
	dir = 4
	},
/turf/open/floor/iron/dark,
/area/shuttle/ruin/caravan/syndicate3)
"sz" = (
/obj/machinery/computer/shuttle/caravan/syndicate3{
	dir = 8
	},
/obj/effect/turf_decal/tile/red{
	dir = 1
	},
/obj/effect/turf_decal/tile/red{
	dir = 8
	},
/turf/open/floor/iron/dark,
/area/shuttle/ruin/caravan/syndicate3)
"um" = (
/obj/machinery/airalarm/syndicate{
	dir = 8;
	pixel_x = -24
	},
/obj/effect/decal/cleanable/dirt,
/turf/open/floor/iron/dark,
/area/shuttle/ruin/caravan/syndicate3)
"vk" = (
/obj/machinery/porta_turret/syndicate/energy,
/turf/closed/wall/mineral/plastitanium/nodiagonal,
/area/shuttle/ruin/caravan/syndicate3)
"vP" = (
/obj/structure/chair/comfy/shuttle{
	dir = 1
	},
/obj/machinery/firealarm/directional/south,
/obj/effect/decal/cleanable/dirt,
/turf/open/floor/pod/dark,
/area/shuttle/ruin/caravan/syndicate3)
"wR" = (
/obj/effect/turf_decal/stripes/line{
	dir = 9
	},
/obj/effect/decal/cleanable/dirt,
/obj/structure/closet/syndicate{
	anchored = 1
	},
/obj/item/clothing/shoes/jackboots,
/obj/item/crowbar/red,
/turf/open/floor/mineral/plastitanium,
/area/shuttle/ruin/caravan/syndicate3)
"yx" = (
/obj/effect/turf_decal/tile/red,
/obj/effect/turf_decal/tile/red{
	dir = 8
	},
/turf/open/floor/iron/dark,
/area/shuttle/ruin/caravan/syndicate3)
"As" = (
/obj/effect/decal/cleanable/dirt,
/obj/effect/turf_decal/tile/red{
	dir = 1
	},
/obj/effect/turf_decal/tile/red{
	dir = 4
	},
/obj/structure/cable,
/turf/open/floor/iron/dark,
/area/shuttle/ruin/caravan/syndicate3)
"BM" = (
/obj/machinery/airalarm/syndicate{
	dir = 8;
	pixel_x = -24
	},
/turf/open/floor/iron/dark,
/area/shuttle/ruin/caravan/syndicate3)
"CO" = (
/obj/structure/table/reinforced,
/obj/item/storage/medkit/regular,
/obj/item/assembly/flash/handheld,
/obj/effect/decal/cleanable/dirt,
/obj/effect/turf_decal/tile/red{
	dir = 1
	},
/obj/effect/turf_decal/tile/red,
/obj/effect/turf_decal/tile/red{
	dir = 4
	},
/turf/open/floor/iron/dark,
/area/shuttle/ruin/caravan/syndicate3)
"Dv" = (
/obj/effect/decal/cleanable/dirt,
/obj/effect/turf_decal/tile/neutral/fourcorners,
/turf/open/floor/iron/dark,
/area/shuttle/ruin/caravan/syndicate3)
"Dy" = (
/obj/effect/decal/cleanable/dirt,
/obj/effect/turf_decal/tile/red,
/obj/effect/turf_decal/tile/red{
	dir = 8
	},
/turf/open/floor/iron/dark,
/area/shuttle/ruin/caravan/syndicate3)
"DC" = (
/obj/effect/turf_decal/stripes/line{
	dir = 4
	},
/obj/structure/closet/crate,
/obj/machinery/power/terminal{
	dir = 1
	},
/obj/item/stack/sheet/iron/twenty,
/obj/item/stack/sheet/glass{
	amount = 10
	},
/obj/item/stack/sheet/mineral/plastitanium{
	amount = 20
	},
/obj/item/storage/box/lights/bulbs,
/obj/item/storage/toolbox/mechanical,
/obj/item/stack/sheet/mineral/plasma{
	amount = 20
	},
/obj/structure/cable,
/turf/open/floor/plating,
/area/shuttle/ruin/caravan/syndicate3)
"Eq" = (
/obj/structure/chair/comfy/shuttle,
/obj/effect/decal/cleanable/dirt,
/turf/open/floor/pod/dark,
/area/shuttle/ruin/caravan/syndicate3)
"ER" = (
/obj/effect/decal/cleanable/dirt,
/obj/machinery/computer/camera_advanced/shuttle_docker/caravan/syndicate3{
	dir = 8
	},
/obj/effect/turf_decal/tile/red{
	dir = 1
	},
/obj/effect/turf_decal/tile/red,
/obj/effect/turf_decal/tile/red{
	dir = 8
	},
/turf/open/floor/iron/dark,
/area/shuttle/ruin/caravan/syndicate3)
"Fv" = (
/obj/effect/mapping_helpers/airlock/locked,
/obj/machinery/door/airlock/hatch{
	id_tag = "caravansyndicate3_bolt_bridge";
	name = "Bridge"
	},
/obj/effect/mapping_helpers/airlock/cyclelink_helper{
	dir = 8
	},
/obj/effect/turf_decal/tile/neutral/fourcorners,
/obj/effect/mapping_helpers/airlock/access/all/syndicate/general,
/turf/open/floor/iron/dark,
/area/shuttle/ruin/caravan/syndicate3)
"Hh" = (
/obj/effect/turf_decal/stripes/line{
	dir = 8
	},
/obj/machinery/light/small/directional/east,
/obj/structure/closet/syndicate{
	anchored = 1
	},
/obj/item/clothing/under/syndicate,
/obj/item/clothing/glasses/night,
/turf/open/floor/mineral/plastitanium,
/area/shuttle/ruin/caravan/syndicate3)
"Ho" = (
/obj/effect/turf_decal/tile/neutral/fourcorners,
/turf/open/floor/iron/dark,
/area/shuttle/ruin/caravan/syndicate3)
"Iq" = (
/obj/structure/chair/comfy/shuttle{
	dir = 4
	},
/obj/effect/turf_decal/tile/red,
/turf/open/floor/iron/dark,
/area/shuttle/ruin/caravan/syndicate3)
"Jk" = (
/obj/machinery/power/smes{
	charge = 5e+006
	},
/obj/effect/turf_decal/stripes/line{
	dir = 5
	},
/obj/effect/decal/cleanable/dirt,
/obj/effect/decal/cleanable/dirt,
/obj/structure/cable,
/turf/open/floor/plating,
/area/shuttle/ruin/caravan/syndicate3)
"Jv" = (
/turf/template_noop,
/area/template_noop)
"Kp" = (
/obj/structure/table/reinforced,
/obj/machinery/button/door{
	id = "caravansyndicate3_bridge";
	name = "Bridge Blast Door Control";
	pixel_x = -16;
	pixel_y = 5;
	req_access = list("syndicate")
	},
/obj/machinery/button/door{
	id = "caravansyndicate3_bolt_bridge";
	name = "Bridge Bolt Control";
	normaldoorcontrol = 1;
	pixel_x = -16;
	pixel_y = -5;
	req_access = list("syndicate");
	specialfunctions = 4
	},
/obj/effect/decal/cleanable/dirt,
/obj/effect/turf_decal/tile/red,
/obj/effect/turf_decal/tile/red{
	dir = 4
	},
/obj/effect/turf_decal/tile/red{
	dir = 8
	},
/turf/open/floor/iron/dark,
/area/shuttle/ruin/caravan/syndicate3)
"KH" = (
/obj/structure/chair/comfy/shuttle{
	dir = 4
	},
/mob/living/simple_animal/hostile/syndicate/ranged/smg/pilot{
	environment_smash = 0
	},
/turf/open/floor/iron/dark,
/area/shuttle/ruin/caravan/syndicate3)
"Lh" = (
/obj/effect/turf_decal/stripes/line{
	dir = 8
	},
/obj/structure/closet/syndicate{
	anchored = 1
	},
/obj/structure/sign/warning/vacuum/directional/north,
/obj/effect/decal/cleanable/dirt,
/obj/item/clothing/shoes/sneakers/black,
/turf/open/floor/mineral/plastitanium,
/area/shuttle/ruin/caravan/syndicate3)
"Lo" = (
/turf/closed/wall/mineral/plastitanium/nodiagonal,
/area/shuttle/ruin/caravan/syndicate3)
"Lv" = (
/obj/machinery/power/shuttle_engine/propulsion/burst/left{
	dir = 8
	},
/turf/open/floor/plating/airless,
/area/shuttle/ruin/caravan/syndicate3)
"Mc" = (
/obj/machinery/light/small/directional/west,
/obj/machinery/button/door/directional/west{
	id = "caravansyndicate3_bolt_starboard";
	name = "External Bolt Control";
	normaldoorcontrol = 1;
	req_access = list("syndicate");
	specialfunctions = 4
	},
/turf/open/floor/iron/dark,
/area/shuttle/ruin/caravan/syndicate3)
"NG" = (
/obj/machinery/power/shuttle_engine/propulsion/burst{
	dir = 8
	},
/turf/open/floor/plating/airless,
/area/shuttle/ruin/caravan/syndicate3)
"Pl" = (
/obj/machinery/porta_turret/syndicate/energy{
	dir = 1
	},
/turf/closed/wall/mineral/plastitanium/nodiagonal,
/area/shuttle/ruin/caravan/syndicate3)
"Rt" = (
/obj/effect/spawner/structure/window/reinforced/plasma/plastitanium,
/obj/machinery/door/poddoor{
	id = "caravansyndicate3_bridge"
	},
/turf/open/floor/plating,
/area/shuttle/ruin/caravan/syndicate3)
"VU" = (
/obj/machinery/light/small/directional/west,
/obj/machinery/button/door/directional/west{
	id = "caravansyndicate3_bolt_port";
	name = "External Bolt Control";
	normaldoorcontrol = 1;
	req_access = list("syndicate");
	specialfunctions = 4
	},
/turf/open/floor/iron/dark,
/area/shuttle/ruin/caravan/syndicate3)
"Wt" = (
/obj/machinery/power/shuttle_engine/heater{
	dir = 8
	},
/obj/structure/window/reinforced{
	dir = 4
	},
/turf/open/floor/plating/airless,
/area/shuttle/ruin/caravan/syndicate3)
"Xa" = (
/obj/effect/turf_decal/stripes/line{
	dir = 9
	},
/obj/effect/decal/cleanable/dirt,
/obj/structure/closet/syndicate{
	anchored = 1
	},
/obj/item/clothing/under/syndicate,
/obj/item/clothing/shoes/sneakers/black,
/turf/open/floor/mineral/plastitanium,
/area/shuttle/ruin/caravan/syndicate3)
"Xd" = (
/obj/machinery/door/airlock/hatch{
	name = "Ready Room"
	},
/obj/effect/mapping_helpers/airlock/cyclelink_helper{
	dir = 4
	},
/obj/effect/turf_decal/tile/neutral/fourcorners,
/obj/effect/mapping_helpers/airlock/access/all/syndicate/general,
/turf/open/floor/iron/dark,
/area/shuttle/ruin/caravan/syndicate3)
"Zv" = (
/obj/effect/turf_decal/stripes/line{
	dir = 6
	},
/obj/machinery/power/port_gen/pacman{
	anchored = 1
	},
/obj/item/wrench,
/obj/effect/decal/cleanable/dirt,
/obj/structure/cable,
/turf/open/floor/plating,
/area/shuttle/ruin/caravan/syndicate3)

(1,1,1) = {"
Jv
Lv
NG
NG
NG
fh
Jv
"}
(2,1,1) = {"
ko
Wt
Wt
Wt
Wt
Wt
ko
"}
(3,1,1) = {"
Lo
Lo
Jk
DC
Zv
Lo
Lo
"}
(4,1,1) = {"
Lo
bV
As
jh
yx
nX
Lo
"}
(5,1,1) = {"
Lo
ge
lC
Ho
yx
vP
Lo
"}
(6,1,1) = {"
Lo
Eq
lC
Ho
Dy
gj
Lo
"}
(7,1,1) = {"
Lo
Hh
pM
Ho
Xa
gm
Lo
"}
(8,1,1) = {"
Pl
Lo
Lo
Xd
Lo
Lo
vk
"}
(9,1,1) = {"
hR
VU
um
Ho
aM
Mc
nP
"}
(10,1,1) = {"
Lo
Lh
mn
Dv
wR
fK
Lo
"}
(11,1,1) = {"
Lo
Lo
Lo
Fv
Lo
Lo
Lo
"}
(12,1,1) = {"
Lo
lX
BM
Ho
ow
ix
Lo
"}
(13,1,1) = {"
Rt
Kp
rX
KH
Iq
CO
Rt
"}
(14,1,1) = {"
Rt
Rt
ER
sz
db
Rt
Rt
"}
(15,1,1) = {"
Jv
Rt
Rt
Rt
Rt
Rt
Jv
"}
